互联网百科

biooner - 谷友
xiaonei - 校内网
SNS,Social Networking Service - 社会化网络
Microblogging - 微博客
Twitter - 推特,微博客
youtube - youtube[无中译名]
facebook - 脸谱
Grid Computing - 晶格计算,网格计算
Cloud Computing - 云计算
bioon - 生物谷，生物在线
casting couch - 潜规则
Frontin - 做作（装逼）
zhuangbility; drunbility - 装逼[网络]
xinhuanet.com - 新华网
long-term evolution，LTE - 长期演进
online-to-offline，O2O - 线上到线下
mobile payment - 移动支付
augmented reality - 增强现实
sohu.com - 搜狐网
User Login - 用户登录
Metaverse - 虚拟世界开源项目
yahoo - 雅虎
hacker - 黑客，骇客
bandwidth - 带宽
Internet Penetration - 互联网普及率
wiki - 维客，维基百科
Alibaba - 阿里巴巴
Wikipedia - 维基百科
commoner - 自费生
www.sina.com - 新浪
baidu - 百度
google - 谷歌
blog - 博客
