内科学百科

renal biopsy - 肾活检
RA(rheumatoid a arthritis) - 类风湿性关节炎
MalloryWeiss syndrome - 马洛里-魏斯综合征
stroke volume - 每搏量
stroke work - 每搏作功
chagoma - 美洲锥虫肿
Menkes disease - 门克斯病
Negri bodies - 内氏小体
taeniasis bovis - 牛带绦虫病
Parinaud oculoglandular syndrome - 帕里诺眼淋巴结综合征
PelizaeusMerzbacher disease - 佩利措伊斯-梅茨巴赫病
Poncet disease - 蓬塞病
PlummerVinson syndrome - 普卢默－文森综合征
extrasystole, premature beat - 期前收缩
Chikungunya fever - 奇昆古尼亚热
tripod sign - 三脚架征
community mental health - 社区精神卫生
body length - 身长
body height - 身高
reninoma - 肾素瘤
biofeedback therapy - 生物反馈治疗
SturgeWeber syndrome - 斯特奇-韦伯综合征
Sones coronary catheter - 松斯冠状动脉导管
Down syndrome - 唐氏综合征
supramitral ring - 二尖瓣上环
trilogy of Fallot - 法洛三联症
tetralogy of Fallot, Fallot tetrad - 法洛四联症
pentalogy of Fallot - 法洛五联症
antisocial personality disorder - 反社会型人格障碍
nontuberculous Mycobacterium - 非结核性分枝杆菌
nontuberculous mycobacteriosis - 非结核性分枝杆菌病
African trypanosomiasis, sleeping sickness - 非洲锥虫病
relapse - 复发
BrillZinsser disease - 复发性斑疹伤寒
Ganser syndrome - 甘瑟综合征
hyperuricemic nephropathy - 高尿酸血症肾病
Graham Steell murmur - 格雷厄姆·斯蒂尔杂音
intrauterine infective tuberculosis - 宫内感染结核病
SabinFeldman dye test - 弓形虫染色试验
HangerRose skin test - 汉格-罗斯皮肤试验
kalaazar, visceral leishmaniasis - 黑热病
mixed infection - 混合感染
acquired immunodeficiency syndrome, AIDS - 获得性免疫缺陷综合征
cholera face - 霍乱面容
Kyasanur forest fever - 基萨那森林热
hydatid disease, echinococcosis - 棘球蚴病
acute severe hepatitis, fulminant hepatitis - 急性重型肝炎
familial hypophosphatemia - 家族性低磷[酸盐]血症
Gaffky scale - 加氏计数法
accelerated idioventricular rhythm - 加速性心室自主心律
Judkins coronary catheter - 贾金斯冠状动脉导管
pseudobulbar paralysis, pseudobulbar palsy - 假[性]延髓性麻痹
schizophrenia - 精神分裂症
mental health - 精神卫生
cytomegalovirus infection - 巨细胞病毒感染
Calabar swelling - 卡拉巴肿
Kernig sign - 凯尔尼格征
Kerandel sign - 克朗德尔征
Crimean hemorrhagic fever - 克里米亚出血热
Kwashiorkor - 夸希奥科
Montenegro test - 利什曼素皮肤试验
Rift Valley fever - 裂谷热
balloon tipped flowdirected catheter - 血流导向气囊导管
subacute severe hepatitis, subacute massive liver necrosis - 亚急性重型肝炎
bulbar paralysis, bulbar palsy - 延髓性麻痹
drug dependence - 药物依赖
hypochondrical neurosis - 疑病性神经症
cholestatic hepatitis - 淤胆型肝炎
primary complex - 原发复合征
essential hypertension, primary hypertension - 原发性高血压
reinfection - 再感染
recrudescence - 再燃
epidemic hemorrhagic fever - 流行性出血热
Romana sign - 罗曼尼亚征
Marburg disease - 马尔堡病
coinfection - 同时感染
renal disease in Waldenstrom macroglobulinemia - 瓦氏巨球蛋白血症肾病
Wedensky phenomenon - 韦金斯基现象
Wedensky effect - 韦金斯基效应
Wedensky facilitation - 韦金斯基易化作用
peripartal heart disease - 围生期心脏病
vitamin B1 deficiency - 维生素B1缺乏病
vitamin B2 deficiency - 维生素B2缺乏病
vitamin C deficiency - 维生素C缺乏病
vitamin D deficiency - 维生素D 缺乏病
cercarien hüllen reaction, CHR - 尾蚴膜反应
paragonimiasis westermani - 卫氏并殖吸虫病
Winterbottom sign - 温特博特姆征
Wenckebach atrioventricular block - 文氏型房室传导阻滞
West Nile fever - 西尼罗热
Schilder disease - 希尔德病
echinococcosis granulosa - 细粒棘球蚴病
nemaline myopathy, rod myopathy - 线状体肌病
Sindbis disease - 辛德毕斯病
hyaline membrane disease of newborn, neonatal respiratory distress syndrome - 新生儿肺透明膜病
myocardial infarction, MI - 心肌梗死
cardiac output - 心排血量
toxic shock syndrome - 中毒性休克综合征
superinfection - 重叠感染
marasmus - 重度消瘦型营养不良
periodic paralysis - 周期性瘫痪
taeniasis suis - 猪带绦虫病
cysticercosis cellulosae, cysticercosis - 猪囊尾蚴病
attention deficit hyperactivity disorder - 注意缺陷障碍[伴多动]
creeping eruption - 匍行疹
type IV renal tubular acidosis - IV型肾小管性酸中毒
TORCH infections - TORCH 感染
stroke, apoplexy - [脑]卒中
Arthus phenomenon - 阿蒂斯现象
Alzheimer disease - 阿尔茨海默病
Ashman phenomenon - 阿什曼现象
Alport syndrome - 奥尔波特综合征
OslerWeberRendu disease - 奥斯勒－韦伯－朗迪病
Balo disease - 巴洛病
Pastia lines - 巴氏线
Casoni test - 包虫皮内试验
strip biopsy - 剥脱活检
fulminating meningococcemia - 暴发型脑膜炎球菌败血症
Binswanger disease - 宾斯旺格病
perseveration - 持续言语
Kawasaki disease - 川崎病
BrodieTrendelenburg test - 大隐静脉瓣功能试验
echinococcosis multilocularis - 多房棘球蚴病
malignant edema - 恶性水肿
child - 儿童
Cranium - 颅腔
distortion - 曲解作用
aortic regurgitation - 主动脉反流
dynamic compliance - 动态顺应性
continuous positive airway pressure - 呼吸道持续正压结氧
acute liver failure - 急性肝衰竭
continuous blood purification - 持续性血液净化疗法
bladder　cancer - 膀胱癌
Urinary - 膀胱
medulla - 延脑
por - 恢复室
Dentist - 牙科医生
negativism - 阻抗行动
Phobia - 恐惧症
repression - 潜抑作用
Resistance - 阻抗
Toxemia of Pregnancy - 妊娠毒血症
Hydatidiform Mole - 水囊状胎块
sthenia syndrome        - 实证翻译公司
syndrome differentiation        - 辨证,脏腑辨证
A syndrome        - A综合征:A型外斜,向下注视时外斜视增大。A型内斜,向上注视时内斜视增大
asthenia syndrome        - 虚证
maximum - 最高
impotence - 杨萎
hysteria - 歇斯底里病
epigastric pain            - 上腹痛
joint pain            - 关节痛
Progesterone - 黄体素
libido - 原欲
Red blood cell - 红血球
refractive error            - 折射异常
Cardiopulmonary Resuscitation (CPR)        - 心肺复苏术
Dysmenorrhea - 经痛
Postpartum hemorrhage - 产後出血
Bronchial Asthma - 支气管性气喘
vitreous body - 玻璃状体
colon　cancer - 结肠癌
soma - 昏睡
restraint - 约束
Nerves - 神经
prostate gland - 前列腺
brain Death - 脑死
Clavicle Fracture - 锁骨骨折
Ophthalmologist - 眼科医师
Hallux Valgus - 大拇指外翻
Circumcision - 包皮环割术
Dermatologist - 皮肤科医师
Dysplasia - 发育不良
Antipyretic - 解热剂
Postpartum - 产後
Molding - 胎头变形
Mumps - 腮腺炎
obsessive-Compulsive Disorder - 强迫性病患
exhibitionism - 暴露狂
Ligaments - 韧带
upper lip - 上唇
pancreatic　cancer - 胰脏癌
Supervisor - 督导护士
Air - 气
catharsis - 情绪宣泄
The cardiovascular system - 心血管系统
tube - 耳咽管
alopecia - 秃头症
vaginal discharge            - 白带
difficulty in walking           - 步行困难
Tendons - 肌腱
Hearing - 听觉的
Tonsillitis - 扁桃腺炎
schizophrenia - 精神分裂病
Pituitary Tumor - 脑下垂体肿瘤
Anorexia Nervosa - 心因性厌食症
semicircular canals - 半规管
Colposcopy - 阴道镜检法
Incubator - 保温箱
foreign body sensation             - 异物感
Corneitis - 角膜炎
Inject - 注射
esophageal　cancer - 食道癌
Intern - 实习医生
abortion - 人工流产induced
Lipoid - 脂肪样的
Prognosis - 预後
Menorrhagia - 经血过多
Artificial Insemination - 人工受精
Bone graft - 骨移植
burning pain            - 灼热痛
Renal Stone - 肾结石
Systemic Lupus Erythematosus - 全身性红斑性狼疮
Tubal Ligation - 输卵管结扎
Intracranial Hemorrhage - 颅内出血
denial - 否认作用
vessels - 血管
The Respiratory System - 呼吸系统
bloody sputum - 血性喀痰
Forceps - 产钳
Necrotizing Enterocolitis - 坏死性小肠结肠炎
The Nervous System - 神经系统
Rachitis - 痀偻症
Homosexual - 同性的
tonsil - 扁桃
mole - 黑斑
ophthalmoscope - 捡眼镜
brain　tumor - 脑癌
Bulimia Nervosa - 心因性暴食症
chemical - 药物的约束
Vulva - 女阴(外生殖器官)
pons - 桥脑
lacrimal canaliculi - 泪小管
Blepharoptosis - 眼睑下垂
Cleft Palate - 颚裂
Paretic - 麻痹患者
Chart - 病历表
Capsule - 胶囊
vaginal bleeding            - 阴道出血
Eye opening - 睁眼反应
Neonatal Asphyxia - 新生儿窒息
listen - 倾听
ambivalence - 感情矛盾
Mannerism - 作态行为
circumcision - 割礼
euphoria - 欣快感
scapegoat - 代罪羔羊
transference - 情感转移
Psychosis - 神经病
conversion - 转化作用
eyestrain - 眼睛疲劳
bruise - 青斑
hyperactivity - 活动过多
insight - 病识感
identification - 认同作用
flank pain            - 侧腹部痛
White blood count - 白血球计数
Ribs - 助骨
canines - 犬齿
Hepatomegaly - 肝肿大
Ureteral stenosis - 输尿管狭窄
sublimation - 升华作用
Empathy - 同理心
confrontation - 面质
Medication - 处方
Eustachian - 欧式管
Wheel chair - 轮椅
pant - 喘息
an artificial tooth           - 义齿
Cleft lip - 兔唇
Muscle atrophy - 肌萎缩
The　Endocrine　System  - 内分泌系统
Intraocular Foreign Body - 眼内异物
Chondromalacia - 软骨软化症
depression - 忧郁
lungs - 肺脏
Bronchioles - 小支气管
ovarian　cancer - 软巢癌
Ambulant - 可走动 不必卧床的病人
posterior chamber - 後眼房
prostate　cancer - 摄护腺癌
primary hepatocellular carcinoma - 原发性肝癌
adrenoleukodystrophy - 肾上腺脑白质营养不良
glomerular filtration rate - 肾小球滤过率
nephritis - 肾炎
pyelonephritis - 肾盂肾炎
nephrology - 肾脏病学
quality of life - 生命质量
biological psychiatry - 生物精神病学
rating scale - 评定量表
tetanus - 破伤风
artificial feeding - 人工喂养
artificial pacemaker - 人工心脏起搏器
schistosomiasis japanica - 日本血吸虫病
carnitine deficiency - 肉[毒]碱缺乏病
botulism - 肉毒中毒
chyluria - 乳糜尿
lactose intolerance - 乳糖不耐受[症]
cor triatriatum - 三房心
tricuspid regurgitation - 三尖瓣反流
quartan malaria - 三日疟
typhoid fever - 伤寒
upper respiratory tract infection - 上呼吸道感染
ejection fraction - 射血分数
social phobia - 社交恐怖症
community mental health - 社区精神卫生
body length - 身长
body height - 身高
neuropathy - 神经病
neurology - 神经病学
septuagenarian - 七旬[代]老人
pacing - 起搏
pacemaker - 起搏器
temperament - 气质
incubation period - 潜伏期
latent infection - 潜在性感染
compulsion - 强迫行为
rigidity - 强直
tonic seizure - 强直发作
hemiparesis - 轻偏瘫
paresis - 轻瘫
hypomania - 轻躁狂
apathy - 情感淡漠
elation - 情感高涨
spheroplast - 球浆体
deflection - 屈折
urinary cytology - 尿细胞学
urinalysis - 尿液分析
urine retention - 尿潴留
concretion - 凝结物
pyuria - 脓尿
malaria - 疟疾
hematemesis - 呕血
Mycobacterium fortuitum - 偶发分枝杆菌
Parkinson disease - 帕金森病
dysuria - 排尿困难
foam cell - 泡沫细胞
ejection murmur - 喷射性杂音
splenomegaly - 脾大
Pick disease - 皮克病
flatus - 屁
hemifacial spasm - 偏侧面肌痉挛
hemiplegia - 偏瘫
migraine - 偏头痛
paranoia - 偏执狂
acariasis - 螨病
ankle clonus - 踝阵挛
retrograde pyelography - 逆行肾盂造影[术]
retrograde amnesia - 逆行性遗忘
median age - 年龄中位数
Mycobacterium avium - 鸟分枝杆菌
urinary incontinence - 尿失禁
term infant - 足月儿
impedance - 阻抗
damping - 阻尼
delirium - 谵妄
belch - 嗳气
hysteria - 癔症
epilepsy - 癫痫
status epilepticus - 癫痫持续状态
stroke volume - 每搏量
portal hypertension - 门静脉高压
nightmare - 梦魇
echolalia - 模仿言语
breast feeding - 母乳喂养
meningitis - 脑[脊]膜炎
encephalopathy - 脑病
electroencephalogram - 脑电图
encephalomyelitis - 脑脊髓炎
cerebral ischemia - 脑缺血
encephalitis - 脑炎
endotoxemia - 内毒素血症
endoscope - 内镜
endoscopic ultrasonography - 内镜超声检查[术]
endoscopy - 内镜检查术
sinus rhythm - 窦性心律
mycotoxicosis - 真菌[毒素]中毒症
epidemic hemorrhagic fever - 流行性出血热
influenza - 流行性感冒
exhibitionism - 露阴癖
patent foramen ovale - 卵圆孔未闭
Rossolimo sign - 罗索利莫征
pulse pressure - 脉压
schistosomiasis mansoni - 曼氏血吸虫病
therapeutic endoscopy - 内镜治疗[术]
ambivalence - 矛盾意向
nursing home - 老人之家
carcinoid - 类癌
cryoablation - 冷冻消融[术]
tenesmus - 里急后重
leishmaniasis - 利什曼病
paedophilia - 恋童癖
fetishism - 恋物癖
Rift Valley fever - 裂谷热
hemoglobinuria - 血红蛋白尿
hematuria - 血尿
thrombophlebitis - 血栓性静脉炎
blood pressure - 血压
oximeter - 血氧计
hemoperfusion - 血液灌流
tuberculous tenosynovitis - 结核性腱鞘炎
polarization - 极化
rapidly progressive glomerulonephritis - 急进性肾小球肾炎
acute hepatic failure - 急性肝［功能］衰竭
acute glomerulonephritis - 急性肾小球肾炎
acute myocardial infarction - 急性心肌梗死
myelopathy - 脊髓病
myelitis - 脊髓炎
familial polyposis coli - 家族性结肠息肉病
abstinence - 戒瘾
monkeypox - 猴痘
breath test - 呼气试验
sliding tube - 滑管
transducer - 换能器
ascariasis - 蛔虫病
mixed infection - 混合感染
mixed feeding - 混合喂养
cholera - 霍乱
opportunistic infection - 机会性感染
myopathy - 肌病
electromyogram - 肌电图
photodynamic therapy - 光动力学治疗[术]
phototherapy - 光疗
photocoagulation - 光凝固[术]
myalgia - 肌痛
amyotrophy - 肌萎缩
amyotrophic lateral sclerosis - 肌萎缩侧索硬化
myasthenia - 肌无力
fibrillation - 肌纤维震颤
myoclonus - 肌阵挛
laser ablation - 激光消融[术]
laser therapy - 激光治疗[术]
melena - 黑粪
erythropoietin - 红细胞生成素
imbecility - 痴愚
congestive heart failure - 充血性心力衰竭
tic - 抽搐
primary memory - 初级记忆
initial treatment - 初治
hemorrhagic pericarditis - 出血性心包炎
depolarization - 除极
triggered activity - 触发激动
Kawasaki disease - 川崎病
lemology - 传染病学
cluster headache - 丛集性头痛
illusion - 错觉
viral hepatitis - 病毒性肝炎
viral meningitis - 病毒性脑膜炎
viral encephalitis - 病毒性脑炎
viral myocarditis - 病毒性心肌炎
dysphoria - 病理性心境恶劣
lactation - 哺乳
unstable angina pectoris - 不稳定型心绞痛
brucellosis - 布氏菌病
jitter - 颤抖
long term care - 长期照料
longevity - 长寿
intestinal obstruction - 肠梗阻
octogenarian - 八旬[代]老人
Babinski sign - 巴宾斯基征
idiocy - 白痴
diphtheria - 白喉
centenarian - 百岁老人
septicemia - 败血症
bladder carcinoma - 膀胱癌
Becker muscular dystrophy - 贝克肌营养不良
irritable bowel syndrome - 肠易激综合征
ultrasonic wave - 超声波
ultrasonic diagnosis - 超声诊断
overdrive - 超速
old myocardial infarction - 陈旧性心肌梗死
train - 成串
dementia - 痴呆
H reflex - H 反射
IgA nephropathy - IgA肾病
QRS complex - QRS波群
QRS loop - QRS环
ST vector - ST向量
passive obedience - 被动服从
hematochezia - 便血
inotropic - 变力性
chronotropic - 变时性
lycanthropy - 变兽妄想
ramp - 变速
viral diarrhea - 病毒性腹泻
infundibular stenosis - [右室]漏斗部狭窄
Q fever - Ｑ热
Alzheimer disease - 阿尔茨海默病
amebic liver abscess - 阿米巴［性］肝脓肿
self-awareness - 自我了解
capillaries - 微血管
Malpractice - 诊疗错误
Absorbent cotton - 脱脂棉
optimum - 最适
flashlight - 手电筒
rubber gloves - 橡胶手套
Ambulance=ambulatory - 救护车(不限於车子只要是搬运病人的船或飞机)
Gauze - 纱布
The Digestive System - 消化系统
Pituitary - 脑下腺
Ureters - 输尿管
molars - 大臼齿
Extern - 医院实习生
Gynecologist - 妇科医生
Reflector - 反光镜
anterior chamber - 前眼房
introjection - 内射作用
blood　clot - 凝血
Breasts - 乳房
Vertebra - 脊椎
Lens - 晶球体
premolars - 小臼齿
nocturnal dyspnea            - 夜间呼吸困难
Registered nurse - (R.N.)取得考试许可证
Crutches - 柺杖
sicca syndrome        - 干燥综合征
obstructive sleep apnea syndrome      - 阻塞性睡眠呼吸暂停综合征
azotemia - 氮质血症
proteinuria - 蛋白尿
lead - 导联
sleep apnea syndrome       - 睡眠呼吸暂停综合征,睡眠无呼吸综合征
syndrome of inappropriate secretion of antidiuretic hormone   - 抗利尿激素异常分泌综合征
extrovert - 外向的人
deaf - 耳聋
muscle pain            - 肌肉痛
Intravenous drip - 点滴
projection - 外射作用
substitution - 取代作用
isolation - 隔离作用
reinforcement - 增强原则
Range of Motion - 运动范围
Estrogen - 动情基素
Suture - 缝合
scratch - 骚养伤
Nasitis - 鼻炎
Malaise - 不适
Antepartum - 分娩前
Testes - 睾丸
helix - 耳壳
liver abscess - 肝脓肿
hepatosplenomegaly - 肝脾大
hepatorenal syndrome - 肝肾综合征
hepatic fibrosis - 肝纤维化
hepatic encephalopathy - 肝性脑病
cirrhosis of liver - 肝硬化
anesthesia - 感觉缺失
sensory nerve conduction velocity - 感觉神经传导速度
paraesthesia - 感觉异常
infectious diarrhea - 感染性腹泻
infective endocarditis - 感染性心内膜炎
hyperbilirubinemia - 高胆红素血[症]
hypertensive heart disease - 高血压心脏病
obstructive uropathy - 梗阻性尿路病
intrauterine infection - 宫内感染
toxoplasmosis - 弓形虫病
ataxia - 共济失调
common pathway - 共同径路
leptospirosis - 钩端螺旋体病
pulmonary tuberculosis - 肺结核
cor pulmonale - 肺源性心脏病
rheumatic heart disease - 风湿性心脏病
parainfluenza - 副流行性感冒
paratyphoid fever - 副伤寒
relapse - 复发
relapse rate - 复发率
retreatment - 复治
peritoneal dialysis - 腹膜透析
laparoscopic cholecystectomy - 腹腔镜胆囊切除[术]
ascites - 腹水
coronary arteriovenous fistula - 冠状动静脉瘘
capture - 夺获
thrush - 鹅口疮
dirofilariasis - 恶丝虫病
malignant hypertension - 恶性高血压
pediatrics - 儿科学
child care - 儿童保健
mitral regurgitation - 二尖瓣反流
mitral valve prolapse - 二尖瓣脱垂
folie à deux - 二联性精神病
fever therapy - 发热疗法
narcolepsy - 发作性睡病
regurgitation - 反胃
Fanconi syndrome - 范科尼综合征
atrial septal defect - 房间隔缺损
atrioventricular block - 房室传导阻滞
AV nodal reentry tachycardia - 房室结内折返性心动过速
stress test - 负荷试验
accessory pathway - 附加径路
possession - 附体
caseous pneumonia - 干酪样肺炎
retch - 干呕
interference - 干扰
hepatomegaly - 肝大
dengue shock syndrome - 登革休克综合征
hypotension - 低血压
Duchenne muscular dystrophy - 迪谢内肌营养不良
endemic typhus - 地方性斑疹伤寒
electrophysiology - 电生理学
orientation - 定向力
disorientation - 定向障碍
arteriosclerosis - 动脉硬化
atherosclerosis - 动脉粥样硬化
action potential - 动作电位
incoordination - 动作失调
transient ischemic attack - 短暂性脑缺血发作
burst stimulation - 短阵快速脉冲刺激
magnifying endoscopy - 放大内镜检查[术]
hypertrophic cardiomyopathy - 肥厚型心肌病
hyperhidrosis - 多汗
polycystic kidney - 多囊肾
polyneuropathy - 多神经病
cholangiectasis - 胆管扩张
lacrimal puncta - 泪孔
liver　cancer - 肝癌
Glycemia - 糖血症
Intraocular pressure - 眼内压
Vasodilatation - 血管扩张
Exhale - 呼吸
Paraplegia - 下半身瘫痪
room　number  - 病房号码
irritable - 易怒的
irrelevant - 答非所问
fantasy - 幻想作用
cervical　cancer - 子宫颈癌
trachoma - 砂眼
stress - 应激
stressor - 应激源
malnutrition - 营养不良
nutritional anemia - 营养性贫血
fluorescent staining method - 荧光染色法
moron - 愚鲁
neologism - 语词新作
primary lesion - 原发病灶
motor aphasia - 运动性失语[症]
reinfection - 再感染
nystagmus - 眼震
drug abuse - 药物滥用
drug dependence - 药物依赖
nocturia - 夜尿
nosocomial infection - 医院内感染
amnesia - 遗忘[症]
pancreatitis - 胰腺炎
depression - 抑郁[症]
depressive state - 抑郁状态
irritability - 易激惹
escape rhythm - 逸搏心律
punning - 意联
confusion - 意识错乱
pica - 异食癖
mania - 躁狂症
cryptococcal meningitis - 隐球菌性脑膜炎
cryptosporidiosis - 隐孢子虫病
infant - 婴儿
infant mortality - 婴儿死亡率
Splenomegaly - 脾肿大
Aseptic - 无菌的
admission date - 住院日期
Engagement - 进入产位
Congenital Malformation - 先天性畸形
Otorrhea - 耳漏
Tympanotomy - 鼓膜穿破术
Stump - 残物
incoherent - 语无伦次
referred pain            - 牵连痛
Leukocyte - 白血球
Extraocular Muscle - 眼外肌
Acute Myocardial Infarction　(AMI) - 急性心机梗塞
Cholelithiasis - 胆石症
Vasoligation - 输精管结扎
Psychiatrist - 精神病医生
delirious - 胆妄的
Patient - 患者,病人
dream - 作梦
pollution - 遗精
compensation - 补偿作用
dissociation - 解离作用
temperature - 体温状况(body
toothache - 齿痛
stupor - 昏迷
warts - 疣
tape measure - 卷尺
an empty stomach           - 空腹
X-ray photograph - X光像片
left-handedness - 左手性
laryngeal mirror - 喉镜
amnesia - 记忆丧失症
neurosis - 神经精神病
displacement - 转移作用
precordial pain            - 心前部痛
Retinal Detachment - 视网膜剥落
Varus - 内翻
Hydronephrosis - 肾水肿
Aplastic Anemia - 再生不良性贫血
Urinary Tract Infection - 尿路感染
Spermatogenesis - 精子生成
Parity - 经产
Hydrocephalus - 水脑
hard　palate - 硬颚
Pediatrician - 小儿科医生
Acute Renal Failure - 急性肾衰竭
Anterior Cruciate Ligament - 前十字韧带
Lipoma - 脂肪瘤
Pulmonary embolism - 肺栓塞
Epilepsy - 癜痫
brain Anoxia - 脑缺氧症
Hyperplasia - 增殖
Menarche - 初经
Mammography - 乳房X光摄影术
judgement - 判断力
id - 原我
symbolism - 象徵作用
Renal pelvis - 肾孟
Vas deferens - 精管
Short of breath - 呼吸短促
aortic regurgitation - 主动脉瓣反流
aortic pressure - 主动脉压
mannerism - 装相
automatism - 自动症
insight - 自知力
total delay - 总延误
behavioral science - 行为科学
pleural thickening - 胸膜增厚
bloody stool - 血便
needle electrode - 针电极
tremor - 震颤
delirium tremens - 震颤性谵妄
mycoplasma pneumonia - 支原体肺炎
fatty liver - 脂肪肝
orthostatic proteinuria - 直立性蛋白尿
cardiac catheterization - 心导管检查
bradycardia - 心动过缓
tachycardia - 心动过速
atrial myxoma - 心房粘液瘤
cardiac insufficiency - 心功能不全
myocarditis - 心肌炎
angina pectoris - 心绞痛
heart failure - 心力衰竭
cardiac rhythm - 心律
arrhythmia - 心律失常
arrhythmogenic - 致心律失常性
hysteresis - 滞后
nephrotoxicity - 中毒性肾损害
hollow fiber dialyser - 中空纤维型透析器
central venous pressure - 中心静脉压
vaccination - 种痘
major depression - 重性抑郁[症]
myasthenia gravis - 重症肌无力
congenital syphilis - 先天性梅毒
congenital heart disease - 先天性心脏病
adenomatous polyp - 腺瘤性息肉
nematodiasis - 线虫病
phased array - 相控阵
peptic ulcer - 消化性溃疡
ablation - 消融
enteritis - 小肠炎
endocarditis - 心内膜炎
cardiac output - 心排血量
cardiac index - 心排血指数
ventricular hypertrophy - 心室肥大
cardiovascular diseases - 心血管疾病
heart sound - 心音
cardiogenic shock - 心源性休克
defibrillation - 心脏除颤
cardiac function - 心脏功能
cardiac pacing - 心脏起搏
scarlet fever - 猩红热
atrophic gastritis - 萎缩性胃炎
bezoar - 胃[肠]石
gastrointestinal bleeding - 胃肠出血
gastroscope - 胃镜
gastric ulcer - 胃溃疡
bloating - 胃气胀
gastroesophageal reflux - 胃食管反流
gastritis - 胃炎
stable angina pectoris - 稳定型心绞痛
carrier - 携带者
euphoria - 欣快
crescentic glomerulonephritis - 新月体肾小球肾炎
hemopericardium - 心包积血
pericardial effusion - 心包积液
pericarditis - 心包炎
coinfection - 同时感染
conjugate deviation - 同向偏斜
gouty nephropathy - 痛风肾病
analgesia - 痛觉缺失
cramp - 痛性痉挛
headache - 头痛
dizziness - 头晕
dialysis - 透析
dialyser - 透析器
dialysate - 透析液
akinesis - 无动力
anuria - 无尿
asystole - 无收缩
incapability - 无行为能力
irresponsibility - 无责任能力
malabsorption - 吸收不良
Schilder disease - 希尔德病
bacterial diarrhea - 细菌性腹泻
bacterial meningitis - 细菌性脑膜炎
renal infarction - 肾梗死
