分子生物学百科

gene chip,biochip,Microarray - 基因芯片
isolelectric focusing (IEF) electrophoresis - 等电聚胶电泳
Argonaute (AGO) - AGO蛋白家族
epitopemapping - 表位作图,表位定位
amino acids    - 氨基酸
microarray technology    - 微阵列技术,芯片技术
gene editing - 基因编辑
genome editing technology - 基因组编辑技术
gene targeting - 基因打靶
Gene Silencing - 基因沉寂,基因沉默
gene probe - 基因探针
Phosphotransferase system - 磷酸转移酶系统
chromothripsis - 染色体碎裂
particle bombardment,gene gun bombardment - 基因枪法,粒子轰击,高速粒子喷射技术,基因枪轰击技术
Luxury gene - 奢侈基因
target gene - 目的基因
Genics - 基因学
Modularity - 模块度
knockout,gene knock-out - 基因敲除，基因剔除
selector genes - 选择基因
Aponecrosis - 凋亡样坏死
gene splicing - 基因剪接
adjuvant vaccine of anti-idiotypic antibody - 抗独特型抗体佐剂疫苗
region-selective pluripotent stem cells，rsPSCs - 区域选择性多能干细胞
adducin - 内收蛋白，聚拢蛋白
house-keeping gene - 管家基因,看家基因,持家基因
parthanatos - PARP-1依赖性细胞死亡
CRISPR（Clustered regularly interspaced short palindromic repeats） - 规律成簇间隔短回文重复
bcl-2 - B细胞淋巴瘤/白血病-2基因
overlapping gene - 重叠基因
anti-idiotypic antibody - 抗XX独特型抗体
polysaccharide degrading enzyme - 海藻多糖降解酶
gap genes - 间隔基因
junk gene - 垃圾基因
adenomatous polyposis coli，APC - 结肠腺瘤样息肉基因
phosphomimetic - 仿磷酸化，磷酸化模拟
colonocyte - 结肠上皮细胞
spliceosome - 基因剪接体
asprosin - 前原纤蛋白C末端多肽
profibrillin - 前原纤蛋白，前肌原纤维蛋白
oncosis - 胀亡，肿胀死亡
annexin   - 膜联蛋白
Breeding by design - 设计育种
serum response factor (SRF) - 血清应答因子
locus control region - 基因座控制区
additive recombination - 插入重组，加插重组
hub protein - 枢纽蛋白
nuvleobase - 核碱基; 核苷碱基; 硷基
colony stimulating factor - 集落刺激因子
adenylyl cyclase - 腺苷酸环化酶
tyrosine kinase - 酪氨酸激酶
essential gene - 必需基因
adaptin - 衔接蛋白[衔接网格蛋白与其他蛋白的胞质区]
genetic counseling    - 遗传咨询
bacterial artificial chromosome (BAC)  - 细菌人工染色体
library     - 库
linkage     - 键、连接
candidate gene    - 后选基因
EMMPRIN - 细胞外基质金属蛋白酶诱导因子
antigenic determinant - 抗原决定基
DNA replication    - DNA复制
codon     - 密码
PFGE - 脉冲场凝胶电泳
interacting proteins - 相互作用蛋白
genetic identity - 遗传一致度;遗传一致性;遗传相似性
genome-wide - 基因组范围的
marker     - 标记
heterozygous     - 杂合子
neurofibromatosis     - 神经纤维瘤病
oligo     - 寡核苷酸
Southern blot    - DNA印记
DNA sequencing    - DNA测序
metaphase     - [分裂]中期
gene mapping    - 基因图谱
birth defect    - 先天缺陷
cytogenetic map    - 细胞遗传图
cholesteryl ester transfer protein - 胆固醇酯转移蛋白
Immune deviation - 免疫偏离
T-DNA Tagging - T-DNA标签
clinical genomics - 临床基因组学
heroin dependent - 海洛因依赖
protein design - 蛋白质设计
structural genomics - 结构基因组学
Gene trap elements - 基因诱捕技术
retrovirus vectors - 反转录病毒载体
prostate cancer    - 前列腺癌
genome     - 基因组
acquired immunodeficiency syndrome (AIDS)  - 获得性免疫缺陷综合征
Western blot    - 蛋白质印记
genetic screening    - 遗传病筛查
nucleus     - 神经核
sex-linked     - 伴性的
animal model    - 动物模型
arabidopsis - 拟南芥
tumor suppressor gene   - 肿瘤抑制基因
pedigree     - 血系/谱系
hematopoietic stem cell   - 造血干细胞
substitution     - 替代
contig     - 重叠群
Recent progress - 新进展
prostate cancer    - 前列腺癌
N nucleotide -  N核苷酸[见于免疫球蛋白和T细胞受体的重链基因，系重排过程中随机插入]
texas Red - [商]德克萨斯红
A band - A带
acetylene - 乙炔
Northern blot    - RNA印记
melanoma     - 黑色素瘤
Parkinson's disease    - Parkinson病
apoptosis     - 凋亡
syndrome     - 综合征
autosomal dominant    - 常染色体显性
deoxyribonucleic acid (DNA)   - 脱氧核糖核酸
mouse model    - 小鼠模型
patent     - 专利权
metagenome - 宏基因组
genome editing - 基因组编辑
phage display system - 噬菌体展示文库
locus     - 部位、场所
mapping     - 描图
dominant     - 显性的
messenger RNA (mRNA)   - 信使RNA
yeast artificial chromosome (YAC)  - 酵母人工染色体
technology transfer    - 技术转让
inherited     - 继承的
translocation     - 易位
genetic gap - 遗传代沟
codon     - 密码
DNA replication    - DNA复制
antigenic determinant - 抗原决定基
EMMPRIN - 细胞外基质金属蛋白酶诱导因子
candidate gene    - 后选基因
linkage     - 键、连接
library     - 库
bacterial artificial chromosome (BAC)  - 细菌人工染色体
genetic counseling    - 遗传咨询
genetic gap - 遗传代沟
adipocyte - 脂肪细胞
intellectual property rights   - 知识产权
homozygous     - 纯合子
cloning     - 克隆
Human Genome Project   - 人类基因组计划
somatic cells    - 体细胞
fluorescence in situ hybridization　(FISH)  - 荧光原位杂交
mitochondrial DNA    - 线立体DNA
in situ hybridization   - 原位杂交
suicide gene    - 自杀基因
polymerase chain reaction (PCR)  - 聚合酶链反应
congenital     - 天生的
gene amplification    - 基因扩增
