动植物学百科

Moschus moschiferus - 原麝
protective tissue - 保护组织
conducting parenchyma - 输导薄壁组织
aerenchyma - 通气薄壁组织
absorbtive parenchyma - 吸收薄壁组织
storage parenchyma - 贮藏薄壁组织
assimilation parenchyma - 同化薄壁组织
ordinany parenchyma - 基本薄壁组织,一般薄壁组织
parenchyma - 薄壁组织
intercalary meristem - 居间分生组织
lateral meristem - 侧生分组织
apical meristem - 顶端分生组织
secondary meristem - 次生分生组织
primary meristem - 初生分生组织
promeristem - 原分生组织
meristem - 分生组织
Chlamydomonasnivalis - 极地雪藻
vitamin            - 维生素
vitol;vitamin            - 维生素，维生命
zebrafish - 斑马鱼
medullary ray，pith ray - 髓射线
Pseudophyllinae - 树螽
Gampsocleis sedakovii - 暗褐蝈螽
transgenic plant vaccine - 转基因植物疫苗
Spinacia oleracea - 菠菜
Rotifera - 轮虫门
chlamydomonas nivalis - 极地雪藻
watermelon snow - 西瓜雪
Abrus cantoniensis - 鸡骨草
Microula sikkimensis - 微孔草
Phylliidae - 叶虫
Tettigoniidae - 螽斯科
heterogeny,alternation of generations,cyclical parthenogenesis - 异态交替,世代交替,周期性孤雌生殖
secondary ray - 次生射线
Bacillaria paradoxa Gmelin - 奇异棍形藻
Kablouna - 卡布劳纳
autoheteroxenous form - 自异宿主型
autonomic nervous system, vegetative nervous system - 自主神经系统
brown fat, multilocular fat - 棕脂肪
claustrum - 闩骨
ctenidium - 栉鳃
ctenophore, Ctenophora(拉) - 栉水母动物
perisinusoidal space of Disse - 窦周[间]隙
palate - 颚区
plerocercoid - 实尾蚴
adaptive capacity - 适应量
bundle cell - 束细胞
numerical taxonomy - 数值分类学
acclimation - 顺应
moss animal, bryozoan, Bryozoa (拉) - 苔藓动物
somatogenesis - 体质发生
regurgitation - 吐弃
desiccation - 脱水
ectoparasite - 外寄生物
acidophilic erythroblast, normoblast, metarubricyte - 晚幼红细胞
metamyelocyte - 晚幼粒细胞
arm, brachiole (棘皮动物) - 腕
brachidium - 腕骨
clutch, brood - 窝
apomixia, apomixis - 无融合生殖
pars nonglandularis (拉), cutaneous part - 无腺区
physical environment - 物理环境
physical resistance - 物理抗性
phylogeny, phylogenesis - 系统发生
micronephridium - 小管肾
trapezium bone - 斜方骨
pericardium - 心包膜
naked name - 虚名
Aristotle's lantern - 亚氏提灯
cingulum - 腰带
lumbosacral plexus - 腰荐丛
lumbosacral joint - 腰荐关节
nyctipelagic plankton - 夜浮游生物
nocturnal - 夜行
dependent differentiation - 依赖性分化
migration - 移行
sclerite - 硬缘(苔藓动物)
onychophoran, Onychophora (拉) - 有爪动物
neoteny - 幼态延续
monoblast - 原单核细胞
protonephridium - 原管肾
proerythroblast, rubriblast - 原红细胞
megakaryoblast - 原巨核细胞
myeloblast - 原粒细胞
primary coelom - 原体腔
exanthropic - 远宅的
basophilic erythroblast, prorubricyte - 早幼红细胞
rectal sac - 直肠囊
implantation - 植入
intermediate junction - 中间连接
mesocuticle - 中角质层
自割 - autotomy
自然驯化 - acclimatization
自稳态 - homeostasis
自异宿主型 - autoheteroxenous form
自主神经系统 - autonomic nervous system, vegetative nervous system
acclimatization - [风土]驯化
extraglomerular mesangial cell, lacis cell - [肾小]球外系膜细胞
communal - [同代]建巢群
outbreak - [种群]暴发
communal - [同代]建巢群
outbreak - [种群]暴发
dark band, A band - 暗带
nasal plug - 鼻栓
organ of Bojanus - 博氏器
mammalogy - 哺乳动物学
mature follicle, Graafian follicle - 成熟卵泡
diastema - 齿隙
dentine - 齿质
primary bronchus - 初级支气管
fenestra - 窗孔
labrum - 唇板
female gamete - 雌配子
sexual mosaic, gynander, gynandromorph - 雌雄嵌合体
cnidarian, Cnidaria (拉) - 刺胞动物
secondary bronchus, mesobronchus - 次级支气管
melanotroph, melanotropic cell - 促黑[色]素激素细胞
thyrotroph, thyrotropic cell - 促甲状腺素细胞
mammotroph, mammotropic cell - 促乳激素细胞
corticotroph, corticotropic cell - 促肾上腺皮质素细胞
somatotroph, somatotropic cell - 促生长激素细胞
survival potential - 存活潜力
clitellum - 环带
environmental resistance - 环境抗性
tardigrade, Tardigrada (拉) - 缓步动物
coxopodite, coxa - 基节
teratogenesis - 畸形发生
activation - 激活
assembly - 集群
parasite - 寄生物
pseudoparasite, spurious parasite - 假寄生虫
interstitial growth - 间质生长
sacrum - 荐骨
sacrococcygeal joint - 荐尾关节
sacral vertebra - 荐椎
sacroiliac joint - 荐髂关节
epigenesis theory, postformation theory - 渐成论
arthropod, Arthropoda (拉) - 节肢动物
tight junction - 紧密连接
synanthropic - 近宅的
stipe - 茎片
spermaceti organ - 鲸蜡器
aggregation - 聚生
giant cell, Dahlgren cell - 巨大细胞
harem - 眷群
ostracum - 壳层
periostracum - 壳皮层
stylet - 口锥
trapezoid [bone] - 棱形骨
amphigamy - 两性结合
hexapod, Hexapoda(拉) - 六足动物
spiral organ, organ of Corti - 螺旋器
Loven's law - 洛文[定]律
phylum - 门
Müllerian duct - 米勒管
membranous cochlea, scala media(拉) - 膜蜗管
spermatheca, seminal receptacle - 纳精囊
endoparasite - 内寄生物
thrombopoiesis - 凝血细胞发生
nemertinean, Nemertinea(拉) - 纽形动物
Panizza's pore - 帕尼扎孔
lamella - 牌板
gametogenesis, gametogeny - 配子发生
habitat - 栖息地
habitat selection - 栖息地选择
eusynanthropic - 栖宅的
rete mirabile - 奇网
cloacal bursa, bursa of Fabricius - 腔上囊
mural rim - 墙缘(苔藓动物)
metathalamus - 丘脑后部
epithalamus - 丘脑上部
hypothalamus - 丘脑下部
trunk, metastomium (环节动物) - 躯干[部]
dedifferentiation - 去分化
Holarctic realm - 全北界
valid name - 确立学名
tertiary bronchus, parabronchus - 三级支气管
diffuse nervous system - 散漫神经系
Semper's organ - 森珀器
seminiferous tubule - 生精小管
grazing - 食植
phytophage, herbivore - 食植动物
Wolffian duct, mesonephric duct - 中肾管
neutral theory - 中性学说
median eye - 中央眼
polychromatophilic erythroblast, rubricyte - 中幼红细胞
myelocyte - 中幼粒细胞
diurnal - 昼行
diurnal vertical migration - 昼夜垂直移动
pillar cell - 柱细胞
seminal vesicle, vesicula seminalis(拉) - 贮精囊
nidation - 着床
autotomy - 自切
A 细胞 - A cell
B 细胞 - B cell
C 细胞 - C cell
栖居性 - eusynanthropic
迷网 - rete mirabile
腔隙 - lacuna
墙缘(苔藓动物) - mural rim
墙缘(苔藓动物) - mural rim
后视丘 - metathalamus
上视丘 - epithalamus
下视丘 - hypothalamus
躯干部 - trunk, metastomium 
全北界 - Holarctic realm
全尾蚴 - plerocercoid
有效名 - valid name
人为驯化 - acclimation
散漫神经系 - diffuse nervous system
森珀器 - Semper's organ
生殖株 - germ line
食植 - grazing
植食动物 - phytophage, herbivore
适应量 - adaptive capacity
嗜铬细胞癌 - pheochromocystoma
数值分类学 - numerical taxonomy
闩骨 - claustrum
苔藓动物 - moss animal, bryozoan, Bryozoa 
梯度变异 - cline
雌性交接器 - thelycum
脱水 - desiccation
外寄生物 - ectoparasite
围心腔 - pericardial cavity
维生素缺乏症 - avitaminosis
吻侧 - rostral side
物理环境 - physical environment
物理抗性 - physical resistance
系统发生 - phylogeny, phylogenesis
消瘦病 - marasmus
小多角骨 - trapezoid [bone]
微肾管 - micronephridium
心脏病 - heart attack
虚名 - naked name
亚氏提灯 - Aristotle's lantern
腰荐神经丛 - lumbosacral plexus
腰荐关节 - lumbosacral joint
夜浮游生物 - nyctipelagic plankton
夜行性 - nocturnal
一雄多雌、单雄多雌 - polygynandry
移行 - migration
硬缘(苔藓动物) - sclerite
优先权 - priority
有爪动物 - onychophoran, Onychophora 
幼体延续 - neoteny
原肾 - protonephridium
远居性 - exanthropic
直肠囊 - rectal sac
栉鳃 - ctenidium
栉板动物 - ctenophore, Ctenophora
中央眼 - median eye
种间费洛蒙(爱洛蒙) - allomone
昼行性 - diurnal
昼夜垂直移动 - diurnal vertical migration
储精囊 - seminal vesicle, vesicula seminalis
转续宿主 - paratenic host
穿孔器 - boring apparatus
survivor - 存活者
meganephridium - 大管肾
hypostracum - 底层
basipodite, basis - 底节
geographical relic species - 地理孑遗种
Tiedemann's diverticulum - 蒂德曼盲囊
Tiedemann's body - 蒂德曼体
second antenna, antenna - 第二触角
apocrine gland - 顶质分泌腺
sponge, Porifera(拉) - 多孔动物
polymorphonuclear granulocyte - 多形核粒细胞
tapetum lucidum, argentea - 反光膜
radial neuroglia cell, Müller's cell - 放射状胶质细胞
independent differentiation, self differentiation - 非依赖性分化
ballooning - 飞航
stratification - 分层
cladistic systematics, cladistics - 分支系统学
Kupffer cell - 肝巨噬细胞
septum - 隔壁 (苔藓动物)
ontogeny, ontogenesis - 个体发生
radix - 根片
guild - 共位群
lacuna - 管道
germinal vesicle - 核泡
brown body - 褐色体(苔藓动物)
trabecula - 横枝(苔藓动物)
metanephridium - 后管肾
opisthonephros - 后位肾
生态同功群 ，同资源种团 - guild
褐色体(苔藓动物) - brown body
横枝(苔藓动物) - trabecula
晚肾 - opisthonephros
缓步动物 - tardigrade, Tardigrada 
回哺 - regurgitation
假寄生 - pseudoparasite, spurious parasite
荐髂关节 - sacroiliac joint
荐尾关节 - sacrococcygeal joint
荐椎 - sacral vertebra
节肢动物 - arthropod, Arthropoda 
共居性 - synanthropic
干部 - stipe
鲸脑油器 - spermaceti organ
眷群 - harem
鲸脑油器 - spermaceti organ
眷群 - harem
口针 - stylet
洛文定律 - Loven's law
纳精囊 - spermatheca, seminal receptacle
牌板 - lamella
栖息地 - habitat
栖地选择 - habitat selection
digitalis cardiac glycoside - 毛地黄类强心苷
digitonin - 毛地黄皂苷
cap[pa] - 帽
cap ridge, crista marginalis - 帽缘
Munk pore - 蒙克孔
fascicle - 密伞花序
Euramerican flora - 欧美植物区系
Eurasian flora - 欧亚植物区系
embryogenesis, embryogeny - 胚胎发育
suspensor - 配囊柄
oligotrophic plant - 贫养植物
umbo - 脐
stand - 群落地段
cauliflory, stand structure - 群落地段结构
community mosaic - 群落镶嵌
ginsenoside - 人参皂苷
ginsengenin - 人参皂苷配基
day-neutral plant - 日[照]中性植物
spadix - 肉穗花序
ray - 伞幅
Shanwang Miocene flora - 山旺中新世植物区系
stevioside - 蛇菊苷
Glossopteris flora - 舌羊齿植物区系
growth form, ecobiomorphism - 生长型
life history, life cycle - 生活史
habitat, ecotope - 生境
[o]ecotone - 生态过渡带
life zone - 生物带
biogeocoenosis complex - 生物地理群落复合体
biosphere, ecosphere - 生物圈
receptacle - 生殖托
pustulan - 石耳素
experimental plant ecology, experi-mental geobotany - 实验植物群落学
cyanophage - 噬蓝藻体
myrmecophyte - 适蚁植物
degree of closing - 疏密度
benthophyte, submerged plant - 水底植物
hydrophilous plant - 水媒植物
tetrad - 四合花粉
taiga, boreal coniferous forest - 泰加林
tubular corolla - 筒状花冠
Turgayan flora - 图尔盖植物区系
indigenous species, native species - 土著种
hypanthium - 托杯
hypocrateriform corolla - 托盘状花冠
dedifferentiation - 脱分化
rare plant, unusual plant - 稀有植物
phylogenesis, phylogeny - 系统发育
halophobe, glycophyte - 嫌盐植物
plantlet - 小植物
staminate strobilus, male cone - 小孢子叶球
synergism - 协同作用
gemma, spore                                               繁殖。 - 芽孢
[sample] plot - 样地
leaf, frond - 叶
reaction wood - 应力木
zoosporangium - 游动孢子囊
sexual generation - 有性世代
shade density, canopy density - 郁闭度
proanthocyanidin - 原花色素
protoblem, primordial veil, primary universal veil - 原菌幕
overtopping - 越顶
trans[], transport - 运输
polygamy - 杂性
vegetation classification - 植被分类
vegetation regionalization - 植被区划
vegetation mapping - 植被制图
phytolemma - 植物皮膜
phytosphere, vegetation circle - 植物圈
phytocoenology, phytocoenostics - 植物群落学
flora - 植物志
middle layer - 中层
midrib - 中脉
seminiferous scale - 种鳞
periplasmodial tapetum - 周缘质团绒毡层
ovuliferous scale - 珠鳞
transport - 转运
abiogenesis - 自然发生说
denuded quadrat - 芟除样方
urn - 蒴壶
sporopollenin - 孢粉素
farnesol - 麝子油醇
Emerson enhancement effect - 埃默森增益效应
dwarf plant - 矮化植物
dwarf plant - 矮生植物
Angara flora - 安加拉植物区系
abortive zoospore - 败育动孢子
middle lamella - 胞间层
endocyanosis - 胞内蓝藻共生
gemma - 胞芽
stylospore - 柄孢子
matric potential - 衬质势
Gigantopteris flora - 大羽羊齿植物区系
ovulate strobilus, female cone - 大孢子叶球
gynogenesis - 单雌生殖
monad - 单花粉
androgenesis - 单雄生殖
lowerland plant - 低地植物
extrazonal vegetation - 地带外植被
lichenan, lichenin - 地衣淀粉
lichenized, lichen-forming - 地衣化的
lichenized hormocysts - 地衣化藻殖孢
strophanthus cardiac glycoside - 毒毛旋花子类强心苷
dyad - 二合花粉
taxon - 分类单位
chorisis - 分离
secretory tapetum - 分泌绒毡层
melittopalynology - 蜂蜜孢粉学
collective fruit, multiple fruit - 复果
compound middle lamella - 复合胞间层
eutrophic plant, eutrophyte - 富养植物
glycyrrhizin - 甘草皂苷
Gondwana flora - 冈瓦纳植物区系
upland plant - 高地植物
psychrophyte - 高山寒土植物
ontogenesis, ontogeny - 个体发育
symbiont - 共生成分
paleoflora, geoflora - 古植物区系
proper margin - 固有盘缘
holdfast - 固着器
resistant sporangium - 厚垣孢子囊
anthocyanin - 花色素苷
receptacle - 花托
Cathaysia flora - 华夏植物区系
perimedullary zone, perimedullary region - 环髓带
thevetia cardiac glycoside - 黄花夹竹桃类强心苷
Hoagland solution - 霍格兰溶液
asiaticoside - 积雪草皂苷
areal disjunction, discontinuous areal - 间断分布区
cutinized layer - 角化层
cuticle - 角质膜
cuticle analysis - 角质膜分析
strangler - 绞杀植物
quiescent center - 静止中心
Knop solution - 克诺普溶液
cyanelle - 蓝色小体
cold injury - 冷害
pinetum cladinosum(拉) - 鹿蕊松林
picetum cladinosum(拉) - 鹿蕊云杉林
London clay flora - 伦敦粘土植物区系
maquis - 马基斯群落
Warburg respirometer - 瓦尔堡呼吸计
Warburg respirometer - 瓦尔堡呼吸计
Woronin hypha - 沃鲁宁菌丝
Woronin body - 沃鲁宁体
leucoanthocyanidin - 无色花色素
leucoanthocyanin - 无色花色苷
asexual flower, neutral flower - 无性花
asexual generation - 无性世代
NPC-classification - NPC 分类
颚区 - palate
tracheid - 假导管;管胞
meristematic cell - 分生组织细胞
phytochrome            - 植物色素；植物光敏素；光敏色素
utricle - 胞果;果囊;小囊;
stephanotis - 千金紫藤香
ptyalin            - 唾液淀粉
disinfection            - 消毒
stabilized            - 稳定的
stabilization            - 稳定化
disinfectant            - 消毒剂
stabilizer            - 稳定剂;固定剂
spraying            - 雾状灌注法;喷雾法
racemization            - 消旋作用
adsorption            - 吸附
rum            - 糖密酒
Suillus            - 兔蕈属(担)
asepsis            - 无菌
specialized            - 特殊的
undercrowding            - 未达拥挤程度
volvocales            - 团藻目
uncoiled            - 未旋卷的
property            - 特性
potency            - 位能，势能
Thlaspi            - 退蓝菜属(十字花科)
parvovirus            - 细小病毒
Physcia            - 蜈蚣苔属(地衣)
pyrogallol            - 五倍子酚;1，2，3三羟基苯;焦性没食子酚
Pygeum            - 臀果木属(蔷薇科)
temperature            - 温度
thermometry            - 温度测量法;测温术
thermometer            - 温度计(表)
synonym            - 同物异名;同义语;同义名称
reticulate            - 网状的
space            - 太空
vicarious            - 同宗并存的
relaxation            - 松弛
relaxin            - 松弛素
reticulin            - 网状硬蛋白质
statistics            - 统计;统计学
statistic            - 统计量;统计值
prosperity            - 旺盛
tapering            - 一端渐尖的;渐狭长
thiophene            - 一硫二烯伍环
trifoliate            - 有三叶的
recessiveness            - 隐性
sylvan            - 有树木的
villous            - 有长软毛的
spermatic            - 有精﹝子﹞或产精﹝子﹞构造的
Porotrichum            - 硬枝藓属
vacuolated            - 有液胞的
sterol            - 硬脂醇
Porate            - 有孔的
porosity            - 有孔的
pinnule            - 羽状小叶
protostele            - 原生中心柱
punctate            - 有油点的
prismatic            - 有棱柱的
primordial            - 原始的;初生的
polygamous            - 有两性花与单性花的;有雌花、雄花与两性花
primitive            - 原始的;未分化的
Phyllanthus            - 油柑属；余甘子属；叶下珠属（大戟科）
Phytophthora            - 疫(病)菌属
Ventilago            - 翼核果属(鼠李科)
stoloniferous            - 有匍匐茎的
warty            - 疣状的
Chlamydia            - 衣原体
pubescent            - 有短软毛的
variegated            - 有条斑的
tryptic            - 胰蛋白酶的
sulcate            - 有条沟的
undernutrition            - 营养不良
sulfonamide            - 乙磺酰胺
type            - 型
xanthophyll            - 叶黄素
thermolabile            - 因热而变化或破热的，不耐热的
primer            - 引发物质
releaser            - 引发者
woolly            - 有绒毛的
vacuolization            - 液胞化;形成液胞
tricuspid            - 有三尖点的;有三小叶的
tagged            - 有标识的;有标志的;用可固定的原素或化合物以供追迹的
plasminogen            - 血酱纤维溶素原
hemagglutinin            - 血凝素
twig            - 小枝
race            - 小种;(同种内)族
serotyping            - 血清学分型
scrapie            - 羊瘙痒病
training            - 训练;锻炼
stress            - 压力;威胁
Thespesia            - 肖槿属;截萼黄槿属(锦葵科)
Bacillus            - 芽胞杆菌属
pickling            - 腌渍
stretching            - 延伸;伸长
Woodsiaceae            - 岩蕨科
vein            - 叶脉(叶片中及花瓣中的维管组织)
venation            - 叶脉型;脉型
prevalence            - 优势
phylla            - 叶片
predominant            - 优势的;主要的
punctiform            - 油点状
bacteriostasis            - 抑菌
porocyte            - 小孔细胞
Puccinia            - 锈病菌属
pitting            - 细胞壁[上的]孔[的]排列[与]分布
suspension            - 悬浮液
vesicle            - 小囊;气室;小胞
theca            - 药室;花粉囊;胞子囊;鞘;外壁
Yersinia            - 耶尔森菌属
subshrub            - 亚灌木
unsealed            - 心皮边缘不合着的
sulfinyl            - 亚磺酰基
phosphite            - 亚磷酸盐
syncarpous            - 心皮合生的
tropic            - 向性的;属于向性的
phototropism            - 向旋光性
relic            - 遗存的;残余的
plasmodieresis            - 细胞质分裂
relationship            - 相关关系;相关性;亲缘
woodlot            - 小片树林
Platanus            - 悬铃木属;筱悬木(属)
physiognomy            - 相观;植物群外观
symphysis            - 相同部愈合
pilosity            - 细被毛
tinea            - 癣
subtilin            - 炫騕蒍?由炫馍黖葀ㄔ耵涟雈肵?
procession            - 先进;先行
threonine            - 息宁胺酸;苏胺酸
Picornaviridae            - 小核糖核酸病毒科
precursor            - 先驱物质;前身
phytase            - 纤维醣磷酸盐脢
Tutcheria            - 石笔木属;榻捷花属(山茶科)
Polypodiaceae            - 水龙骨科;瓦苇科
biosynthesis            - 生物合成
tetragonal            - 四角形的
Spirogyra            - 水绵属(绿藻)
tetracyclic            - 四轮的;四重的
triplet            - 三联体;三联碱
rhamnose            - 鼠李醣
reproduction            - 生殖[作用]
tetrahedral            - 四边的;四面的
Trema            - 山黄麻属(榆科)
原锥  - protocone
胚壳  - protoconch
impermeability - 不透性
sulcus - 槽
marsh - 草本沼泽
grassland - 草地
meadow - 草甸
steppe - 草原
lateral root - 侧根
side body - 侧泡体
lateral organ - 侧生器官
lateral bud - 侧芽
lateral branch - 侧枝
tea saponin - 茶叶皂苷
twining stem - 缠绕茎
semipermeable membrane - 半透膜
bract scale - 苞鳞
bract - 苞片
wall pressure - 胞壁压
utricle - 胞果
middle lamella - 胞间层
intercellular space - 胞间隙
gemma - 胞芽
conidiogenous cell - 产孢细胞
long day - 长日照
matric potential - 衬质势
stratification - 成层现象
red tide - 赤潮
gibberellin - 赤霉素
primary structure - 初生结构
mentha-camphor - 薄荷脑
protective layer - 保护层
arctic realm - 北极界
prairie - 北美草原
essential element - 必需元素
tichus - 壁层
axoneme - 鞭毛轴丝
sapwood - 边材
form - 变型
stalk cell - 柄细胞
adventitious bud - 不定芽
trabecula - [腹菌]产孢组织基板
thorn - [棘]刺
stipe - [菌]柄
culm - [空心]称
spur - [枝]距
[vegetation] continuum - [植被]连续体
endothecium - [蒴]内层
p-protein - p-蛋白
dwarf plant - 矮化植物
hyposulphite - 次亚硫酸盐
hymenial - 子实层的
hymenium - 子囊层;子实层
hypermetabolism - 亢进性代谢
hypertonic - 高渗透压;高张
hypertrophic - 肥大的;膨大的
hyphae - 菌丝
Hypocotyl - 胚茎;子叶下轴;下胚轴
hydroxyl group - 羟根;羟基;氢氧根
acyclovir            - 无环鸟苷（阿昔洛韦）
tartness            - 酸味
tetrarch            - 四束木质组织;四芒型
Thrixspermum            - 台湾风兰属(兰科)
synchronism            - 同时性;齐时性
Taiwania            - 台湾杉属(杉科)
smallpox            - 天花
antigen presenting cell - 抗原呈递细胞
granulosa cell - 颗粒细胞
family - 科
foramen - 壳顶孔
operculum - 壳盖
beak - 壳尖
available name - 可用学名
renewable resource - 可再生资源
eyelash - 睫毛
internode - 结间[段]
sister group - 姐妹群
tight junction - 紧密连接
aggressiveness - 进攻性
evolution - 进化
proximal - 近端的
stipe - 茎片
cauline - 茎生的
lens - 晶状体
squel - 惊叫声
seminal vesicle - 精囊[腺]
spermatid - 精子细胞
warning mark - 警戒标志
landscape ecology - 景观生态学
collum - 颈板
carotid body - 颈动脉体
internal carotid artery - 颈内动脉
cervical nerve - 颈神经
mesothelium - 间皮
scapular - 肩羽
scapula - 肩胛骨
key - 检索[表]
parsimony - 简约性
diagnosis - 鉴别
vulnerable species - 渐危种
aerobic respiration - 需氧呼吸
pressure flow - 压流
blastic - 芽殖[产孢]的
subsection - 亚组
action spectrum - 作用光谱
creeper - 匍匐枝
sink - 壑
terpene - 萜
terpenoid - 萜类化合物
prophyll - 先出叶
promycelium - 先菌丝
gland - 腺[体]
correlation - 相关[性]
coumarin - 香豆素
response - 响应
phototropism - 向光性
tropism - 向性
tunica - 小包薄膜
purse - 小包袋
pedicel - 小柄
floret - 小花
bulblet - 小鳞茎
spikelet - 小穗
microphyll - 小型叶
leaflet - 小叶
plantlet - 小植物
columella - 小柱
microsporogenesis - 小孢子发生
microspore mother cell - 小孢子母细胞
synergism - 协同作用
stress - 胁迫
carpel - 心皮
vascular cylinder - 维管柱
pit - 纹孔
torus - 纹孔塞
pitting - 纹孔式
ornamentation - 纹饰
agravitropism - 无向重力性
physical barrier - 物理障碍
sucker - 吸根
imbibition - 吸涨[作用]
imbibition water - 吸涨水
savanna - 稀树草原
Hill reaction - 希尔反应
axis - 体轴
natural product - 天然产物
assimilate - 同化[产]物
assimilation - 同化[作用]
enation - 突起
depolarization - 脱极化
polymer            - 聚合物;聚合体;多重体
polymerase            - 聚合物酶;重合体酶
Prunus            - 李属(蔷薇科)
stereoscopic            - 立体观的
quantum            - 量子
stereoscope            - 立体显微镜
Pteroxygonum            - 捩丝藓属
Physcomitrium            - 立碗藓属
Ulex            - 林乃豆属(豆科)
threshold            - 临界;(若干现象之)下部限界
gonococcus            - 淋球菌
Thyrostachys            - 廉序竹属
phosphoserine            - 磷丝胺酸
sulfate            - 硫酸盐
phosphate            - 磷酸化合物；磷酸盐
phosphoinositide            - 磷酸肌醇
progression            - 进展状态
strain            - 菌株、毒株
spermatophore            - 精胞;精子托;精子荚
starter            - 开端者;启动物
Pleioblastus            - 苦竹属
thalassemia            - 库雷氏贫血症;地中海贫血症
quinine            - 奎宁(奎宁~59_1~)
Legionella            - 军团菌属
rhizoctonia            - 菌核菌的
ring            - 菌轮;锷
Pluchea            - 阔苞菊属(菊科)
wax            - 蜡
tyrosine            - 酪胺酸(酥胺酸;贝他对-羟苯基阿伐胺基丙酸;阿伐胺基一对一羟基氢化桂皮酸)
Tripterygium            - 雷公藤属(卫矛科)
Rhynia            - 雷尼蕨属(泥盆纪)
purity            - 精选度;清洁度;纯度
virescence            - 开始变成绿色
sperm            - 精子(动物);精核(植物)
antitoxin            - 抗毒素
unilateral            - 靠在一边的
coxsackievirus            - 柯萨奇病毒
transmissible            - 可传染的;可遗传的
susceptible            - 可感染性
static            - 静止的;平衡的
reducible            - 可还原的
tartar            - 酒石
theobromine            - 可可碱
Platycodon            - 桔梗属
reversible            - 可逆性的
viable            - 可生长发育的;效配子
plastic            - 可塑的;可改变的
Klebsiella            - 克雷伯菌属
torus            - 孔阜;(孔膜中的)圆节;花托
spur            - 距;(萼或花瓣的)中空[作]尾状[的]部[分]
rainfall intensity           - 降雨强度
chronic infection           - 慢性感染
surface layer           - 表层
latent infection           - 潜伏感染
vegetative growth           - 营养生长
plaque formation           - 空斑形成
plant formation           - 植物群系
radio frequency           - 放射频率
plant hormone           - 植物激素
stomatal index           - 气孔指数
refractive index           - 屈折率
triple helix           - 三重螺旋
radiation injury           - 放射伤害
vacuum filter           - 真空泸器
plant growth           - 植物生长
spontaneous generation           - 自然发生
population growth           - 族群成长
starch granule           - 淀粉粒
population genetics           - 族群遗传学
reduced form           - 还原型
tropical grasses           - 热带禾草类;暖地牧草类
multiple drug resistance          - 多重耐药
aspergillus flavus           - 黄曲霉
protoplast fusion           - 原生质体融合
specific gravity           - 比重
prosthetic group           - (酵素的)辅成基;(酵素中的)非蛋白质(的)部份
genetic group           - 基因群
Stephania tetrandra S. Moore         - 石蟾蜍;防己(本草经);乌龟梢(H.C.);粉防己;汉防己;金线钓葫芦根;独脚蟾蜍根;倒地拱;蟾蜍薯;引葫芦
wheat germ           - 小麦芽
precocious germination           - 早发性萌芽
aspergillus fumigatus           - 烟曲霉
physiological function           - 生理机能
pathogenic fungi           - 致病性真菌
rate of release          - 解离率
polymerase chain reaction          - 聚合酶链反应
place of origin          - 原产地
Zostera marina L.          - 大叶藻(P.拾亦);薀藻(G.);甘藻(日本)
herpes simplex virus          - 单纯疱疹病毒
ring porous wood          - 环孔材
van der Waals force         - 凡得瓦氏力
Rosa roxburghii Tratt          - 缫丝花(图改);刺蘼(图考)
acquired immunodeficiency syndrome          - 获得性免疫缺陷综合症
dengue shock syndrome          - 登革休克综合征
sucrose phosphate synthetase          - 蔗糖磷酸盐合成酶
antimicrobial susceptibility test          - 药敏试验
acute phase protein          - 急性期蛋白
latent membrane protein          - 潜伏感染膜蛋白
outer membrane protein          - 外膜蛋白
temperature sensitive mutation          - 温度敏感突变
Potamogeton malaianus Miq.          - 笹叶藻(日本)
regulation of metabolism          - 代谢调节
Pteris vittata L.          - 蜈蚣草;长叶甘草蕨
spindle cells - 纺缍细胞
spine - 棘
spleen - 脾
squamous epithelium - 扁平上皮
skeletal muscle - 骨骼肌
skin - 皮肤
small intestine - 小肠
small scales - 小鳞
smooth muscle - 平滑肌
snout - 吻
cross - 十字形骨针
herbivore - 食草动物
esophagus - 食管
life table - 生命表
vital process - 生命过程
life expectancy - 生命期望
dermatome - 生皮节
ecotope - 生态区
[ecological] niche - 生态位
ecosystem - 生态系[统]
texture            - 质地
phycoerythrin            - 藻红素
rib            - 主脉;中脉
Uvaria            - 紫玉盘属(番荔枝科)
racemase            - 自D-或L-异性体形成D-L-异性体等量的混合物酵素
S2            - 自交第二代
pillar            - 柱;囊轴;朔轴
S3            - 自交第三代
S1            - 自交第一代
syndrome            - 综合症状
unguis            - 爪
summation            - 总反应(1.由二次或二次以上的重复的刺激所成而增加的反应2.由二个刺激所形成的反应)
transduction            - 转导
transformation            - 转化
superposition            - 纵生;重迭
plicae            - 纵褶
stand            - 植物群丛;林分
plasmid            - 质粒
plastid            - 质体(植物细胞中胞器)
plastoquinone            - 质体醌
plasmal            - 脂肪酸醛
proton            - 质子
pathogenicity            - 致病性
virulence            - 致病性
substitution            - 置换;替代
Physcomitrella            - 中欧葫芦藓属(于)
specific            - 种的;物种的;特异的
spp.            - 种的缩写(多数)
sp.            - 种的缩写;单数
tunic            - 种皮;(鳞茎的)被层
umbilical            - 种脐的
provenance            - 种源地
repeatability            - 重复性;复现率
recombinant            - 重组型
propagation            - 增殖;繁殖
vegetation            - 植被;植物群落
vegetal            - 植物[性]的
adhesin            - 粘附素
resynthesis            - 再合成作用
β-lactam            - β-内酰胺类
protean            - 1.变化的、有钗h方式与形状的2.衍生(的)蛋白质，(蛋白质受各种作用后衍生的蛋白质
β-lactamase            - β-内酰胺酶
trama            - (担子器果二膜层间的)支持构造;菌髓
variant            - 1.变异体;变员2.变式
sprout            - 1.初生芽条2.新芽条的生长;发芽
pleomorphic            - (若千细菌与丝状菌之)多形性;多态性
racemic            - 1.串状花的;2.消旋的
secretin - 分泌素
secretion - 分泌，分泌物
sodium - 钠
somatostatin - 生长激素释放抑制因子
sound amplification - 声音扩大
spawning - 产卵
species recognition - 种分辨
specific weight - 比重
sperm cells - 精细胞
spermatophore - 精球，精筴
spermatozoa - 游动精子
spherical aberration - 变形骨
spinal canal - 脊髓管
spinal cord - 脊髓
spinal ganglion - 脊髓结
spinal neurons - 脊椎神经元
sella turcica - 土耳其鞍
sensory nerves - 感觉神经
sensory organs - 感觉器官
serosa - 浆膜
serotonergic - 血清基能
serotonin - 血清基
serum - 血清
sex cells - 性细胞
sex determination - 性别决定
sex hormones - 性激素
shoulder girdle - 肩带
single cone - 单锥
rib - 肋骨
riboflavin - 核黄素
ribosomes - 核糖素
mutual assimilation - 相互同化作用
mutual exclusion - 互相排除
mutualism - 互依共存
mucin - 黏蛋白
Mucor - 毛霉属（毛霉菌科）；酵霉属
multifactorial - 多因子的
multilayer - 多层；多分子层
multilocular - 多室的
multivariate analysis - 多变值分析
murine - 鼠灰色
Murraya - 七里香属；月橘属（芸香科）
mother tree - 母树
motile - 运动性的；有自动力的
motility - 机动性
mounting medium - 封固剂
movement - 运动性的；有自动力的
mower - 刈草机
mowing - 刈草
Mucuna - 油麻藤属（豆科）
Mukdenia - 枫叶草属（虎耳草科）
mull - （有机物无机物混合而成的）腐植层
montane - 1.山岳的2.乔木线下的山地
mor - （不与无机物混淆的）致密有机层；酸性腐植土
Morchella - 网伞蕈属
Morinda - 羊角藤属（茜草科）
Morinda officinalis How - 巴戟天（本草经）
Moringa - 本辣木属；&#33838;菜树属（辣木科）
mos - 生态种群
mosaic - 嵌合体；镶嵌状
mosaic theory - 嵌合说；镶嵌说
monograph - （对于某一分类群或某一专题详细的）综合报告
monolayer - 单细胞层；单分子层
monoterpenes - 单松烯类
monotype - 单型；独一模式标本
monovalent - 单价
monsoon forest - 季节风雨林
Monascus - 红曲菌属
mongrel - 1.二不同系统交配后获得的个体2.杂种3.祖先不明〔的〕动物
monogamous - 1.一夫一妇的2.一雌一雄的3.有雌雄合同的花药的
monogamy - 一雌一雄配合
monophyletic - 单一系统发生的；单源的
mobile phase - 移动相
molal - 克分子量的；重量莫耳的
molar - 克分子的；莫耳的
molding - 培土；模制
molecular bond - 分子键
monad - 单价染色体
mixotrophic - 混合营养性的
mixtures - 混合物
Mnium - 提灯藓属（提灯藓科）
nick - （核酸）链裂
nicotinamide - 烟~59_1~酰胺
nicotine - 烟~59_1~
Nitraria - 白刺属（蒺藜科）
nitrifier - 硝化菌
nitrocellulose - 硝化纤维素；火药棉
nitrogen assimilation - 氮〔素〕同化作用
nitrogen cycle - 氮气循环
neophytes - 新来植物；新来杂草
neotype - 新模式标本
nerve - 叶脉
Nigella - 黑种草属（毛茛科）
needle crystal - 针晶
needle-shaped - 针形的
negative control - 负〔的〕控制
Neocheiropteris - 扇蕨属（水龙骨科）
Neolitsea - 新木姜子属（樟科）
natural history - 博物学；自然学
natural law - 天然法则，自然律
natural population - 天然族群
natural resistance - 天然抵抗性
natural system - 自然分类系统
naturalist - 博物学者
naturalization - 归化
nature - 天然；自然界；本性
necrosis - 坏死；局部溃坏
negative value - 负值
Negundo - 复叶类（枫树）
nanism - 不正常的小型；矮型
Nanophyton - 小蓬属（藜科）
nasty - 倾性；不定向运动
natant - 浮游的
ferox - 刺极多的；残暴的
ferrous - 二价铁的；低铁的；亚铁的
fertile - 可孕性的；有生殖能力；肥沃的
fertility - 可孕性；生殖力
fertility rate - 可孕率
fibrinolysis - 纤维蛋白分解
fascicle - 束集；聚伞（花序）；密伞花序
fast - 抗拒性；耐性
fatal - 致死
Fatsia - 八角金盘属（五加科）
feedback inhibition - 回馈抑制；返馈抑制
feedback mechanism - 回馈机制；返馈机制
female cone - 雌球花
fairy ring - 菌环；仙环
falcate - 镰刀状
female reproductive system - 雌〔性〕生殖系统
feminity - 雌性
fen - （美国的）卑湿性；沼泽地
Rubra            - 红糖枫类(枫树科)
pod            - 荚果;豆荚
capsule            - 荚膜
hemagglutination            - 红细胞凝集
Tanakae            - 峨屏草属
reactive            - 反应的
supplemental            - 额外的;增加的
reactor            - 反应器
reactant            - 反应物质
reactivity            - 反应性
quadrat            - 方框
tube            - 萼筒;花冠筒;(合萼或合瓣花冠的基部)
transection            - 横断面
Reoviridae            - 呼肠病毒科
Russula            - 红毒蕈属(担)
Sphaerella            - 红雪藻属
quercetin            - 槲皮素;槲黄素
photocontrol            - 光控制
Tongoloa            - 红花芹属(伞形花科;香芹科)
lymphocytes - 淋巴球
lysosome - 微溶体
macrophages - 巨噬细胞
macula - 色斑
macula densa - 致密胃斑肾
male - 雄性
male sex hormone - 雄性激素
malleolus - 踝
mating - 交配
matrix - 基质
maxilla - 上颌骨
mesentery - 肠系膜
mesoderm - 中胚层
mesonephros - 中肾
metamorphosis - 变态
metanephros - 后肾
infraorbital - 眶下骨
ingroup - 内群
inhibition - 抑制作用
inhibitory - 抑制
integration - 整合作用
integument - 皮，体被
intercellular fluid - 细胞间液
intercellular substance - 细胞物质
internal environment - 体内环境
internal secretion - 内分泌
horizontal plane - 水平面
hump - 驼背
hyaline cartilage - 透明软骨
hydrofoil - 水翼
hyoid - 舌，Y形的
后嗅检器  - aboral osphradium
后眼列  - posterior row of eyes
弧胸型  - arcifera
护器  - tutaculum
跗  - ankle
前闭壳肌  - anterior adductor muscle
前鞭毛体  - promastigote
前牙堤  - promargin
前盔  - frontal shield
前膜  - frontal membrane
前脑  - prosencephalon, forebrain
前神经孔  - anterior neuropore
前庭沟  - vestibular groove
前幽门孔  - prosopyle
原淋巴母细胞  - prolymphoblast
前直肌  - anterior rectus muscle
前中眼  - anterior median eye
漂鸟  - wandering bird
栖血的  - sanguicolous
鳍  - fin
鳍式  - fin formula
鳍条  - fin ray
气味腺  - scent gland, odoriferous gland
前背侧板  - prozonite
texture            - 质地
phycoerythrin            - 藻红素
rib            - 主脉;中脉
Uvaria            - 紫玉盘属(番荔枝科)
racemase            - 自D-或L-异性体形成D-L-异性体等量的混合物酵素
S2            - 自交第二代
pillar            - 柱;囊轴;朔轴
S3            - 自交第三代
S1            - 自交第一代
syndrome            - 综合症状
unguis            - 爪
summation            - 总反应(1.由二次或二次以上的重复的刺激所成而增加的反应2.由二个刺激所形成的反应)
transduction            - 转导
transformation            - 转化
superposition            - 纵生;重迭
plicae            - 纵褶
stand            - 植物群丛;林分
plasmid            - 质粒
plastid            - 质体(植物细胞中胞器)
plastoquinone            - 质体醌
plasmal            - 脂肪酸醛
proton            - 质子
pathogenicity            - 致病性
virulence            - 致病性
substitution            - 置换;替代
Physcomitrella            - 中欧葫芦藓属(于)
Orientia            - 东方体属
polycyclic            - 多环性;多周期性
steppe            - 东南欧与西亚的无树木的大区域草原;高草原
polygraph            - 多种波动描写器
syndynamics            - 动态群落学
polyad            - 多子体;多粉体
Polyporaceae            - 多孔菌科(菌蕈目);猢狲座蕈科
tentacle            - 触手;触须
spread            - 传布;蔓延;展开
prolate            - 长球形
transmission            - 传达;传递
pollination            - 传粉作用;授粉
tropine            - 颠茄酚
potential            - 电位
Zostera            - 大叶藻属(眼子菜科)
Potentiometer            - 电位计
streptokinase            - 蛋白质分解酵素之一
voltage            - 电压
polyploidy            - 多倍性;倍数性
vasa            - 导管
wilting            - 凋萎
pleomorphism            - 多形性;多态性
regulation            - 调节;调整;节制
pistillate            - 雌蕊的
tandem            - 串行
Stagonospora            - 长穗菅茅斑叶病菌属(不)
traumatic            - 创伤的
rosetting            - 丛叶;簇叶
rosette            - 丛叶基生基;着地丛叶型;莲座型;丛生叶;叶丛
presence            - 常存度;出现率
stout            - 粗大的
unisexual            - 单性的
vernal            - 春天的;晚春
topography            - 地势;地形学
ruber            - 纯红毛
topographical            - 地形的;地方分布的
promotion            - 促进作用
potting            - 钵植
sowing            - 播种
profile            - 侧形
Psoralea            - 补骨脂属(豆科)
stratified            - 成层的
unequal            - 不等的
subunit            - 次级单位
ruminate            - 不规则地;明暗交错的
prickle            - 刺;针
Sphenophyllum            - 叉叶蕨属
X            - X线照射后第二代
tegmentum            - (包围在芽上的)鳞片层
prairie            - (北美中西部的)大草原
annual rings - 年轮
antagonists - 拮抗物
antibodies - 抗体
anus - 肛门
aorta - 主(大)动脉
age composition - 年龄组成
ageing - 老化
air passage - 气道
abdomen - 腹部
abdominal cavity - 腹腔
abnormal  - 反常的
absorption efficiency - 吸收效率
impermeability - 不透性
sulcus - 槽
marsh - 草本沼泽
grassland - 草地
meadow - 草甸
steppe - 草原
lateral root - 侧根
side body - 侧泡体
lateral organ - 侧生器官
lateral bud - 侧芽
lateral branch - 侧枝
tea saponin - 茶叶皂苷
twining stem - 缠绕茎
semipermeable membrane - 半透膜
bract scale - 苞鳞
bract - 苞片
wall pressure - 胞壁压
utricle - 胞果
middle lamella - 胞间层
intercellular space - 胞间隙
gemma - 胞芽
conidiogenous cell - 产孢细胞
long day - 长日照
matric potential - 衬质势
stratification - 成层现象
red tide - 赤潮
gibberellin - 赤霉素
primary structure - 初生结构
mentha-camphor - 薄荷脑
protective layer - 保护层
arctic realm - 北极界
prairie - 北美草原
essential element - 必需元素
tichus - 壁层
axoneme - 鞭毛轴丝
sapwood - 边材
form - 变型
stalk cell - 柄细胞
chondrocyte - 软骨细胞
parotid gland - 腮腺
gill lamella - 鳃瓣
盐生阶段演替  - halosere
眼  - eye
消化循环腔  - gastrovascular cavity
胸腺  - chest gland
雄性先熟雌雄同   - protandrous hermaphrodite
雄原核  - male pronucleus
休眠子  - dormozoite, hypnozoite
嗅毛  - olfactory hair
下目  - infra-order
下前锥  - paraconid
下鳃骨  - hypobranchial bone
心区  - cardiac region
心输出量  - cardiac output
新科  - new family, fam. nov.
陷丝  - trapline
吸泡  - alveolus
吸收细胞  - absorptive cell
习惯化  - habituation
习性  - habit
细胞集合  - cell aggregation
细胞间质  - intercellular substance
下下锋  - hypoconulid
resin - 树脂
bound water - 束缚水
fascicular cambium - 束中形成层
senescence - 衰老
phelloderm - 栓内层
frost - 霜冻
binomial nomenclature - 双名法
double fertilization - 双受精
water potential - 水势
filament - 丝体
tetrad - 四合花粉
bog - 酸沼
auxin - 生长素
growth rate - 生长速率
viability - 生存力
ecocline - 生态差型
ecological amplitude - 生态幅
bioassay - 生物测定
biodiversity - 生物多样性
alkaloid - 生物碱
biotic ecotype - 生物生态型
biogenesis - 生源说
reproductive organ - 生殖器官
receptacle - 生殖托
generative cell - 生殖细胞
交接管  - copulatory tube
交配群集  - synhesia
交配库  - mating pool
颈翼膜  - cervical ala
寄生去势  - parasitic castration
颊  - cheek
颊线  - cheek stripe, malar stripe
角膜缘  - corneal limbus
角质鳍条  - ceratotrichia
铰合部  - hinge
接合后体  - exconjugant
节体  - segmenter
节细胞层  - ganglion cell layer
肌皱丝  - myophrisk
间质生长  - interstitial growth
肩峰突  - acromion
睑板  - tarsal plate, tarsus
极管  - polar tube
极性  - polarity
棘口尾蚴  - echinostome cercaria
棘头体  - acanthella
环状胎盘  - ring placenta
寰椎  - atlas
肌  - gemellus muscle
肌槽  - muscular socket
肌带  - muscle strand
肌隔  - myocomma
肌膜  - sarcolemma
肌肉  - muscle
后锥  - metacone
后腕  - posterior arm
后吸盘  - posterior sucker
后嗅检器  - aboral osphradium
后眼列  - posterior row of eyes
弧胸型  - arcifera
护器  - tutaculum
跗  - ankle
前闭壳肌  - anterior adductor muscle
前鞭毛体  - promastigote
前牙堤  - promargin
前盔  - frontal shield
前膜  - frontal membrane
前脑  - prosencephalon, forebrain
前神经孔  - anterior neuropore
前庭沟  - vestibular groove
前幽门孔  - prosopyle
原淋巴母细胞  - prolymphoblast
前直肌  - anterior rectus muscle
前中眼  - anterior median eye
漂鸟  - wandering bird
reducing sugar           - 还原糖
refined sugar           - 石蜜(唐本草);白糖
type strain           - 模式菌株
wild strain           - 野毒株
pine tree           - 松树
wild type           - 野生型
phylogenetic tree           - 系统树
ring vessel           - 环纹导管
Salmonella typhi           - 伤寒沙门菌
transfer technique           - 搬运技术;移置技术
radioactive substance           - 放射性物质
tolerance test           - 耐力测验
agglutination test           - 凝集试验
sterility test           - 无菌检验
tritiated thymidine           - 3H胸腺嘧啶
neutralization test           - 中和作用
reaction time           - 反应时间
protective sheath           - 保护鞘
water stress           - 极缺水
synthetic system           - 合成系统
surface tension           - 表面张力
B. subtilis           - 枯草芽胞杆菌
pioneer species           - 光驱种
Gram stain           - 革兰染色
reproductive system           - 生殖系统
vegetative stage           - (噬菌体的)营养(体时)期
steady state           - 稳定状态
primary structure           - 原生构造
tillering stage           - 分蘗期
prolate spheroidal           - 长圆球形
surface soil           - 表土
virgin soil           - 处女地;原始土壤
sterile seed           - 无效种子
standard solution           - 定规液，标准溶液
root rot           - 根腐病
S. sonnei           - 宋内志贺菌
Neisser stain           - 奈瑟染色
strange species           - 稀有种;罕见种
type specificity           - 模式专一性;模式特性
random sampling           - 逢机取样
photoperiodic reaction           - 光周〔期〕反应；光周作用
xylem sap           - 木质部树液
asexual reproduction           - 无性繁殖
sexual reproduction           - 有性繁殖
radiation sickness           - 辐射病
taking root           - (植物)成活
drug resistance           - 耐药性
polar transport           - 极性运转;极部运输
sulfate reduction           - 硫酸盐还原作用
turnover rate           - 回转率;转变率
corm - 球茎
region - 区
chlorosis - 缺绿症
anoxia - 缺氧
association - 群丛
variant - 群丛变型
sociability - 群集度
stand - 群落地段
alliance - 群属
formation - 群系
operculum - 囊盖
collar - 囊领
lamina - 囊盘总层
apophysis - 囊托
columella - 囊轴
endocarp - 内果皮
internal valve - 内壳面
endospore - 内生孢子
fertility - 能育[性]
annual ring - 年轮
ornithophily - 鸟媒
agroecology - 农业生态学
vesicle - 泡囊
embryo - 胚
coleorhiza - 胚根鞘
embryo sac - 胚囊
critical period - 临界期
ergot alkaloid - 麦角类生物碱
indumentum - 毛被
trichome - 毛状体
cap[pa] - 帽
loma - 秘鲁草原
thicket - 密灌丛
fascicle - 密伞花序
ovule - 胚珠
suspensor - 配囊柄
gametophyte - 配子体
turgor pressure - 膨压
resistance - 抗性
tensile strength - 抗张强度
mantle - 壳套
renewable resources - 可再生资源
clone - 克隆
colporate - 孔沟的
annulus - 孔环
mineral element - 矿质元素
aging - 老化
susceptibility - 敏感性
sensitive plant - 敏感植物
chaff - 膜片
flower bud - 花芽
anther - 花药
anther culture - 花药培养
cutinization - 角化[作用]
canthaxanthin - 角黄素
cutin - 角质
cuticle - 角质膜
squalene - 角鲨烯
scrub - 灌丛
photocatalyst - 光催化剂
photosynthesis - 光合作用
photosystem - 光系统
silica cell - 硅质细胞
national flora - 国家植物志
follicle - 果
carpopodium - 果柄
calyx - 花萼
iridoid - 环烯醚萜类化合物
iridoid glycoside - 环烯醚萜苷
annular thickening - 环状加厚
desert - 荒漠
etiolation - 黄化
flavone - 黄酮
appressorium - 附着器
coverage - 盖度
glycyrrhizin - 甘草皂苷
perception - 感受
nasty - 感性
irritability - 感应性
higher plant - 高等植物
alpine flora - 高山植物区系
hypertonic solution - 高渗溶液
fruit - 果实
centrum - 果心
hypersensitivity - 过敏性
stone - 核
drupe - 核果
chalaza - 合点
chalazogamy - 合点受精
trace element - 痕量元素
constancy - 恒有度
palate - 喉凸
sclerenchyma - 厚壁组织
collenchyma - 厚角组织
chlamydospore - 厚垣孢子
rhizome - 根[状]茎
root/shoot ratio - 根冠比
root system - 根系
symbiont - 共生成分
paleobotany - 古植物学
annular thickening - 环状加厚
desert - 荒漠
etiolation - 黄化
flavone - 黄酮
appressorium - 附着器
coverage - 盖度
glycyrrhizin - 甘草皂苷
perception - 感受
nasty - 感性
irritability - 感应性
higher plant - 高等植物
alpine flora - 高山植物区系
hypertonic solution - 高渗溶液
fruit - 果实
centrum - 果心
hypersensitivity - 过敏性
stone - 核
drupe - 核果
chalaza - 合点
chalazogamy - 合点受精
trace element - 痕量元素
constancy - 恒有度
palate - 喉凸
sclerenchyma - 厚壁组织
collenchyma - 厚角组织
chlamydospore - 厚垣孢子
rhizome - 根[状]茎
root/shoot ratio - 根冠比
root system - 根系
symbiont - 共生成分
paleobotany - 古植物学
nitrogen fixation - 固氮作用
holdfast - 固着器
limb - 冠檐
tracheid - 管胞
areal - 分布区
areal type - 分布区型
taxon - 分类单位
meristem - 分生组织
pycnidium - 分生孢子器
ramification - 分枝式
rima - 缝裂孔口
corona - 副花冠
stylus - 副体
subsidiary cell - 副卫细胞
ramulus - 副枝
imbricate - 覆瓦状的
winterness - 冬性
tundra - 冻原
hood - 兜状瓣
embryonic stem cell - 胚胎干细胞
embryonic stage - 胚胎期
embryology - 胚胎学
embryonic tissue - 胚胎组织
germ - 胚原基
allotype - 配模标本
pair bonding - 配偶键
splenic artery - 脾动脉
cutaneous artery - 皮动脉
sebaceous gland - 皮脂腺
skin fold - 皮褶
amensalism - 偏害共生
frequency - 频度
parallelism - 平行进化
energy flow - 能流
fertility - 能育性
rhizoids - 拟根共肉
parasitoid - 拟寄生物
stabilimentum - 匿带
age distribution - 年龄分布
annual cycle - 年周期
bird - 鸟
ornithology - 鸟类学
urethra - 尿道
allantois - 尿囊
agglutination - 凝集[作用]
umbilicus - 脐(贝壳)
trachea - 气管
tracheal cartilage - 气管软骨
stigma - 气门
emigration - 迁出
hallux - 拇趾
order - 目
cold hardiness - 耐寒性
capsule - 囊
blastula - 囊胚
cysticercus - 囊尾蚴
meninges - 脑[脊]膜
Paneth cell - 帕内特细胞
ovulation - 排卵
egestion - 排遗
lamella - 牌板
paracrine - 旁分泌
vesicle - 泡状体(苔藓动物)
blastocyst - 胚泡
cecum - 盲肠
shaft - 锚杆
anchor - 锚形体
hair - 毛
pelage - 毛被
streptomycin            - 链霉素
pita            - 龙舌兰纤维
Streptomyces            - 链霉属
phosphatase            - 磷酸盐酶
Streptococcus            - 链球菌
terrestrial            - 陆生的;地上生的
phosphoryl            - 磷氧基
phospholipase            - 磷脂酶
lecithinase            - 卵磷脂酶
whorl            - 轮
Verticillium            - 轮霉菌属
phosphine            - 膦
polymer            - 聚合物;聚合体;多重体
polymerase            - 聚合物酶;重合体酶
Prunus            - 李属(蔷薇科)
stereoscopic            - 立体观的
quantum            - 量子
stereoscope            - 立体显微镜
Pteroxygonum            - 捩丝藓属
Physcomitrium            - 立碗藓属
Ulex            - 林乃豆属(豆科)
threshold            - 临界;(若干现象之)下部限界
gonococcus            - 淋球菌
Thyrostachys            - 廉序竹属
phosphoserine            - 磷丝胺酸
sulfate            - 硫酸盐
phosphate            - 磷酸化合物；磷酸盐
phosphoinositide            - 磷酸肌醇
progression            - 进展状态
strain            - 菌株、毒株
spermatophore            - 精胞;精子托;精子荚
starter            - 开端者;启动物
Pleioblastus            - 苦竹属
thalassemia            - 库雷氏贫血症;地中海贫血症
quinine            - 奎宁(奎宁~59_1~)
Legionella            - 军团菌属
rhizoctonia            - 菌核菌的
ring            - 菌轮;锷
Pluchea            - 阔苞菊属(菊科)
wax            - 蜡
tyrosine            - 酪胺酸(酥胺酸;贝他对-羟苯基阿伐胺基丙酸;阿伐胺基一对一羟基氢化桂皮酸)
Tripterygium            - 雷公藤属(卫矛科)
Rhynia            - 雷尼蕨属(泥盆纪)
purity            - 精选度;清洁度;纯度
virescence            - 开始变成绿色
sperm            - 精子(动物);精核(植物)
antitoxin            - 抗毒素
unilateral            - 靠在一边的
coxsackievirus            - 柯萨奇病毒
transmissible            - 可传染的;可遗传的
oxygen - 氧
palatine - 颚骨
pancreas - 胰
occipital - 枕骨
occiput - 枕部，后头
odontoblasts - 生齿细胞
olfactory cells - 嗅细胞
olfactory epithelium - 嗅上皮
oligodendrocyte - 贫树突质神经细胞
oocyte - 卵母细胞
oogonia - 卵原细胞
optical system - 视觉系统
oral cavity - 口腔
nephros - 肾
nerve endings - 神经末梢
nerve fiber - 神经纤维
nerve ganglia - 神经节
nerve net - 神经网
nervous system - 神经系统
nervous tissue - 神经组织
neural crest - 神经脊
neurite - 轴突
neurofilament - 神经丝
neuroglia - 神经胶质
neuroglial cell - 神经胶细胞
neurohormones - 神经激素
neuron - 神经原
neurosecretory cells - 神经分泌细胞
myofibril - 肌原纤维
myofilaments - 肌丝
neurotensin - 神经紧张素
neurotransmitter - 神经传导物
neutrophilic granulocytes - 中性粒细胞
nitrogen - 氮
node of Ranvier - 兰氏结
noradrenaline - 副肾上腺素
muscularis mucosae - 黏膜肌层
myoglobin - 肌红蛋白
myomere - 肌节
myopia - 近视
myosin - 肌凝蛋白
myotomal portion - 生肌节部
nape - 项部
nasal - 鼻
nasal cavity - 鼻腔
nasal septum - 鼻隔
neck region - 颈区
micropyle - 卵膜孔
microvilli - 微绒毛
midbrain - 中脑
perilymph - 外淋巴
nostrils - 鼻孔
notochord - 脊索
nucleolus - 核仁
osteoclast - 破骨细胞
otoconia - 耳砂
otolith - 耳石
outgroup - 外群
oval body - 卵圆体
ovary - 卵巢
ovum - 卵细胞
oxygen - 氧
palatine - 颚骨
pancreas - 胰
occipital - 枕骨
occiput - 枕部，后头
odontoblasts - 生齿细胞
olfactory cells - 嗅细胞
olfactory epithelium - 嗅上皮
oligodendrocyte - 贫树突质神经细胞
oocyte - 卵母细胞
oogonia - 卵原细胞
optical system - 视觉系统
oral cavity - 口腔
nephros - 肾
nerve endings - 神经末梢
nerve fiber - 神经纤维
nerve ganglia - 神经节
nerve net - 神经网
nervous system - 神经系统
nervous tissue - 神经组织
neural crest - 神经脊
neurite - 轴突
neurofilament - 神经丝
neuroglia - 神经胶质
neuroglial cell - 神经胶细胞
neurohormones - 神经激素
neuron - 神经原
neurosecretory cells - 神经分泌细胞
myofibril - 肌原纤维
myofilaments - 肌丝
neurotensin - 神经紧张素
neurotransmitter - 神经传导物
neutrophilic granulocytes - 中性粒细胞
nitrogen - 氮
node of Ranvier - 兰氏结
noradrenaline - 副肾上腺素
muscularis mucosae - 黏膜肌层
myoglobin - 肌红蛋白
myomere - 肌节
radiant energy           - 辐射能
potential energy           - 位能;势能
wind erosion           - 风蚀
population            - 族群波动;族群大小周期[性][的]婆动
tissue            - 组织;体素
progenitor            - 祖先
tachyphylaxis            - 转速反应
subulate            - 钻头形
rhodoxanthin            - 紫松果黄素
vertex            - 最高点;顶端
transmigration            - 转移;(离子)转移
state            - 状态
tracer            - 追踪物
quasi-static            - 准静态的
pigmentation            - 着色;色素产生
Porphyra            - 紫菜属(红)
syringin            - 紫丁香素
prematurity            - 早熟性
integration            - 整合
topiary            - 整形观赏树木
positive            - 正的
Kale - 羽衣甘蓝
agamospermous - 无融结籽的;无融合生殖植物
portal areas - 汇管区
Microcystis aeruginosa - 铜绿微囊藻
鬣鳞  - crest scale
磷酸型外壳(腕足动物)  - phosphatic type
菱形体  - rhombogen
老年体  - senile
透明幼   - puerulus larva
绿带  - green belt
卵黄  - yolk
卵黄分裂  - yolk cleavage
类骨质  - osteoid
梨状叶  - pyriform lobe
离巢雏  - fledgling
连孔  - communication pore
裂冠型触手冠  - schizophorus lophophore
裂体腔法  - schizocoelic method
合巢群集  - synoecium
合纤毛  - syncilium
河口  - estuary
核二型性  - nuclear dualism
核周质  - perikaryon
有颌类  - gnathostomata
冠海胆型  - diadematoid type
横桥  - cross bridge
横纹面  - striated area
后肾  - metanephros
后凹椎体  - opisthocoelous centrum
rumen - 瘤胃
ostium - 流入孔
keel - 龙骨[突]
basket - 笼状体
competition - 竞争
net primary productivity - 净初级生产力
in situ conservation - 就地保护
intermedia - 居间骨针
gizzard - 咀嚼器(苔藓动物)
polymerization - 聚合作用
aggregation - 聚生
barbel - 口须(鸟)
stylet - 口锥
button - 扣状体
dispersal - 扩散
cere - 蜡膜
senile - 老体
redia - 雷蚴
thylakoid - 类囊体
group - 类群
conoid - 类锥体
shuttle - 棱脊状骨针
fledgling - 离巢雏
megakaryocyte - 巨核细胞
harem - 眷群
sigma - 卷轴骨针
drought resistance - 抗旱性
窦房结  - sinoatrial node
窦周间隙  - perisinusoidal space of Disse
毒刺  - poisonous spine
毒爪  - poison claw
端泡  - terminal vesicle
顶生齿  - acrodont
端纤毛环  - telotroch
多裂肌  - multifidus muscle
垫  - pulvinus, thenar
调整式发育  - regulative development
定向反应  - orientation reaction
冬睡  - winter sleep
动基体  - kinetoplast
动脉锥  - conus arteriosus
多数共同树  - majority consensus tree
单眼  - ocellus
单针六星骨针  - monoxyhexaster
弹性  - elasticity
岛屿特有种  - island endiemic species
等辐骨针  - isoactinate
动物形态学  - animal morphology
大肠  - large intestine
镫骨  - stapes
共居性  - synanthropic
晶状体泡  - lens vesicle
精子  - sperm, spermatozoon
精子凝集素  - sperm-agglutinin
精细胞  - spermatid
科  - family
壳  - corona, shell
壳盖  - operculum
荐椎  - sacral vertebra
交接管  - copulatory tube
交配群集  - synhesia
交配库  - mating pool
颈翼膜  - cervical ala
寄生去势  - parasitic castration
颊  - cheek
颊线  - cheek stripe, malar stripe
角膜缘  - corneal limbus
角质鳍条  - ceratotrichia
铰合部  - hinge
接合后体  - exconjugant
节体  - segmenter
节细胞层  - ganglion cell layer
肌皱丝  - myophrisk
间质生长  - interstitial growth
肩峰突  - acromion
睑板  - tarsal plate, tarsus
极管  - polar tube
极性  - polarity
棘口尾蚴  - echinostome cercaria
棘头体  - acanthella
环状胎盘  - ring placenta
寰椎  - atlas
肌  - gemellus muscle
肌槽  - muscular socket
肌带  - muscle strand
肌隔  - myocomma
肌膜  - sarcolemma
肌肉  - muscle
后锥  - metacone
后腕  - posterior arm
后吸盘  - posterior sucker
后嗅检器  - aboral osphradium
后眼列  - posterior row of eyes
弧胸型  - arcifera
护器  - tutaculum
跗  - ankle
前闭壳肌  - anterior adductor muscle
前鞭毛体  - promastigote
前牙堤  - promargin
前盔  - frontal shield
嗅毛  - olfactory hair
下目  - infra-order
下前锥  - paraconid
下鳃骨  - hypobranchial bone
心区  - cardiac region
心输出量  - cardiac output
新科  - new family, fam. nov.
陷丝  - trapline
吸泡  - alveolus
吸收细胞  - absorptive cell
习惯化  - habituation
习性  - habit
细胞集合  - cell aggregation
细胞间质  - intercellular substance
下下锋  - hypoconulid
resin - 树脂
bound water - 束缚水
fascicular cambium - 束中形成层
senescence - 衰老
phelloderm - 栓内层
frost - 霜冻
binomial nomenclature - 双名法
double fertilization - 双受精
water potential - 水势
filament - 丝体
tetrad - 四合花粉
bog - 酸沼
auxin - 生长素
growth rate - 生长速率
viability - 生存力
ecocline - 生态差型
ecological amplitude - 生态幅
bioassay - 生物测定
biodiversity - 生物多样性
alkaloid - 生物碱
biotic ecotype - 生物生态型
biogenesis - 生源说
reproductive organ - 生殖器官
receptacle - 生殖托
generative cell - 生殖细胞
spike - 穗状花序
placenta - 胎座
liverwort - 苔类[植物]
bryophyta - 苔藓植物
C4 photosynthesis - 碳-4光合作用
C/N ratio - 碳氮比
carbon assimilation - 碳同化
body cell - 体细胞
ginsenoside - 人参皂苷
phloem parenchyma - 韧皮薄壁组织
volvocales            - 团藻目
uncoiled            - 未旋卷的
property            - 特性
potency            - 位能，势能
Thlaspi            - 退蓝菜属(十字花科)
parvovirus            - 细小病毒
Physcia            - 蜈蚣苔属(地衣)
pyrogallol            - 五倍子酚;1，2，3三羟基苯;焦性没食子酚
Pygeum            - 臀果木属(蔷薇科)
temperature            - 温度
thermometry            - 温度测量法;测温术
thermometer            - 温度计(表)
synonym            - 同物异名;同义语;同义名称
reticulate            - 网状的
space            - 太空
vicarious            - 同宗并存的
relaxation            - 松弛
relaxin            - 松弛素
reticulin            - 网状硬蛋白质
statistics            - 统计;统计学
statistic            - 统计量;统计值
prosperity            - 旺盛
cephalosporin            - 头孢霉素
sugar            - 糖
saccharification            - 糖化作用
Stenoloma            - 乌蕨属(鳞始蕨科)
microbiology            - 微生物学
prominent            - 凸出的
penton            - 五邻体
thermograph            - 温度记录器
quinate            - 五小叶的
Q10            - 温度系数
subsoil            - 下层土;心土
rachis            - 穗轴;叶轴;中轴
xenic            - 外来生物的
stevioside            - 甜菊苷
Weismannism            - 外士曼说
Clostridium            - 梭菌属
revolute            - 外旋的;向后旋的
streak            - 条班
striation            - 条纹
stripe            - 条纹;纵条
quadriplex            - 四重式
terpenes            - 萜类
Trichophyton            - 顽藓菌属
stasis            - 停滞;郁积
acyclovir            - 无环鸟苷（阿昔洛韦）
tartness            - 酸味
tetrarch            - 四束木质组织;四芒型
Thrixspermum            - 台湾风兰属(兰科)
thermal neutron           - 热中子;热能中子
B. ovis           - 绵羊布鲁菌
nontuberculosis mycobacteria           - 非结核分枝杆菌
species name           - 种名
specific name           - 种名
Quaternary period           - 第四纪
photosynthetic phosphorylation           - 光合磷酸化作用
culture medium           - 培养基
 M protein           - M蛋白
random mutation           - 逢机突变
tillering node           - 分蘗节
protein molecules           - 蛋白质分子
relaxation oscillation           - 弛缓振动
type method           - 模式标本法
outer membrane           - 外膜
vertical migration           - 垂直移动;垂直播迁
plasmic membrane           - 原生质膜，细胞膜
Cryptococcus neoformans           - 新生隐球菌
resolving power           - (显微镜的)解像力
reducing power           - 还原力
 preferment           - 酵素原;酶原
nuclear material           - 核质
upper lip           - (唇形花冠的)上唇
respiratory movement           - 呼吸运动
weighted mean           - 加权[平]均数
preventive medicine           - 预防医药
T lymphocytes           - T型淋巴球
basic medium           - 基础培养基
H. pylori           - 幽门螺杆菌
positive pressure           - 正压
K. pneumoniae           - 肺炎克雷伯菌
Streptococcus pneumoniae           - 肺炎链球菌
redox reaction           - 选原氧化反应
phosphoribosyl pyrophosphate           - 焦磷酸核糖
physiological differentiation           - 生理(的)背腹性
terminal differentiation           - 最后分化
hepatitis E           - 戊型肝炎
infectious disease           - 传染病
pot culture           - 盆植
synchronized culture           - 同调培养;同步培养
sterile culture           - 无菌培养
suspension culture           - 悬浮培养
submerged culture           - 液中培养
rooted cutting           - 插条苗
progressive development           - 渐进发育;前进发育
residual effect           - 残余效应
Poisson distribution           - 卜瓦松氏分布
cytopathic effect           - 细胞病变效应
radiation effects           - 放射效应
random distribution           - 逢机分布;随机分布
spire - 螺旋部
egoism - 利己行为
altruism - 利它行为
cuboidal epithelium - 立方上皮
pillar - 立柱
granulocyte - 粒细胞
amphibian - 两栖动物
schizont - 裂殖体
merozoite - 裂殖子
prey - 猎物
spiral arm - 螺旋腕
logistic equation - 逻辑斯谛方程
choroid plexus - 脉络丛
cirrus - 蔓足
squama - 鳞状膜片
lymphatic vessel - 淋巴管
primate - 灵长类
leadership - 领头
territory - 领域
nestling - 留巢雏
rumen - 瘤胃
ostium - 流入孔
keel - 龙骨[突]
basket - 笼状体
competition - 竞争
net primary productivity - 净初级生产力
in situ conservation - 就地保护
intermedia - 居间骨针
gizzard - 咀嚼器(苔藓动物)
polymerization - 聚合作用
aggregation - 聚生
barbel - 口须(鸟)
stylet - 口锥
button - 扣状体
dispersal - 扩散
cere - 蜡膜
senile - 老体
redia - 雷蚴
thylakoid - 类囊体
group - 类群
conoid - 类锥体
shuttle - 棱脊状骨针
fledgling - 离巢雏
megakaryocyte - 巨核细胞
harem - 眷群
sigma - 卷轴骨针
drought resistance - 抗旱性
窦房结  - sinoatrial node
窦周间隙  - perisinusoidal space of Disse
毒刺  - poisonous spine
hypermetabolism - 亢进性代谢
hypertonic - 高渗透压;高张
hypertrophic - 肥大的;膨大的
hyphae - 菌丝
Hypocotyl - 胚茎;子叶下轴;下胚轴
hydroxyl group - 羟根;羟基;氢氧根
overpopulation - 个体数过多
ovist - 卵源论者
oxygen content - 含氧量
oxygenation - 加氧作用
o-xylene - 邻-茬;1，2-二甲苯
Oxyria - 山蓼属（蓼科）
P/O ratio - 磷氧比率
pacemaker - 节律点
Osmundaceae - 紫萁科
outbreak - 大量发生
outcross - 异交；远系杂交
outgrowth - 过度生长
oval - 广椭圆形；卵圆
ovarium - 子房
ovotid; o&ouml;tid - 卵细胞
ovulate - 有胚珠的
Osmanthus fragrans Lour. - 金桂
osmiophilic - 嗜锇的
Osmunda cinnamomea L. var. asiatica Fernald - 分株紫萁；桂皮紫萁
organ system - 器官系
organic molecule - 有机分子
organism - 生物；（有机体个体演化史中的延续的单位）
orient - 定向
ornithine - 鸟胺酸（二氨缬草酸；d-2，５-二胺基戊酸；鸟粪胺酸）
Orophea - 澄广花属（番荔枝科）
open type - 开放型
opium - 鸦片；雅片
opposite - 对生
optimum pH - 最适酸碱度
optimum temperature range - 最适温度范围
Opulus - 琼花类（忍冬科）
orange - 柑橘，甜橙
orchard - 果树园
orcinol - 5-甲基一苯一酚一〔1.3〕
Oreas - 山毛藓属
Ormosia - 红豆树属（豆科）
Olpidium trifolii Schr&ouml;ter - 白花三叶草火肿病菌
Onychium - 金粉蕨属（中国蕨科）
oogenesis - 卵的形成；卵子发生
oomycetes - 卵菌类；游走菌类（藻菌）
Oospora - 马铃荤痂皮病菌属
opacity - 混浊；不透明；暗度
optimum - 最适度；最适量
O-enzyme - O-酵素
polymerase chain reaction          - 聚合酶链反应
place of origin          - 原产地
Zostera marina L.          - 大叶藻(P.拾亦);薀藻(G.);甘藻(日本)
herpes simplex virus          - 单纯疱疹病毒
ring porous wood          - 环孔材
van der Waals force         - 凡得瓦氏力
Rosa roxburghii Tratt          - 缫丝花(图改);刺蘼(图考)
acquired immunodeficiency syndrome          - 获得性免疫缺陷综合症
dengue shock syndrome          - 登革休克综合征
sucrose phosphate synthetase          - 蔗糖磷酸盐合成酶
antimicrobial susceptibility test          - 药敏试验
acute phase protein          - 急性期蛋白
latent membrane protein          - 潜伏感染膜蛋白
outer membrane protein          - 外膜蛋白
temperature sensitive mutation          - 温度敏感突变
Potamogeton malaianus Miq.          - 笹叶藻(日本)
regulation of metabolism          - 代谢调节
Pteris vittata L.          - 蜈蚣草;长叶甘草蕨
spindle cells - 纺缍细胞
spine - 棘
spleen - 脾
squamous epithelium - 扁平上皮
skeletal muscle - 骨骼肌
skin - 皮肤
small intestine - 小肠
small scales - 小鳞
smooth muscle - 平滑肌
snout - 吻
cross - 十字形骨针
herbivore - 食草动物
esophagus - 食管
life table - 生命表
vital process - 生命过程
life expectancy - 生命期望
dermatome - 生皮节
ecotope - 生态区
[ecological] niche - 生态位
ecosystem - 生态系[统]
Cephalotaxaceae - 三尖杉科
Cephalotaxus - 三尖杉属
texture            - 质地
phycoerythrin            - 藻红素
rib            - 主脉;中脉
Uvaria            - 紫玉盘属(番荔枝科)
racemase            - 自D-或L-异性体形成D-L-异性体等量的混合物酵素
S2            - 自交第二代
pillar            - 柱;囊轴;朔轴
S3            - 自交第三代
S1            - 自交第一代
syndrome            - 综合症状
larva - 幼鱼
lateral line - 侧线
lateral line system - 侧线管系
lateral occipital - 后头侧骨
lateral veins - 侧静脉
leather - 皮
lectotype - 选模标本
lens - 晶体
lens capsule - 晶体体囊
lid - 盖，帽
lip - 唇
liver - 肝脏
liver cells - 肝细胞
intestinum - 肠
inversion - 倒位
iridescence - 虹彩
isthmus - 峡
jaw muscles - 颔肌
joint surface - 接触面
jugal - 轭
jugular - 颈
keratin - 角蛋白
lacrimal - 泪骨
lacunae - 空隙，裂口，胞窝
lamellae - 瓣层
flavonoid - 黄酮类化合物
ash - 灰分
volatile oil - 挥发油
mixed bud - 混合芽
vigor - 活力
sociation - 基群丛
basal cell - 基细胞
excitability - 激感性
pole - 极
polar nucleus - 极核
assemblage - 集聚
mass flow - 集流
monsoon forest - 季[风]雨林
capsule - 夹膜
rhizoid - 假根
aril - 假种皮
nut - 坚果
after-ripening - 后熟[作用]
respiratory rate - 呼吸速率
arcus - 弧形带
floral nectary - 花[上]蜜腺
flower - 花
perianth - 花被
pollen tube - 花粉管
pollen mother cell - 花粉母细胞
flood - 泛滥平原
flooding - 浸水
floral formula - 花式
xiphoid            - 剑形的
vignin            - 豇豆球蛋白
reducer            - 还原者;还原剂
teratogenesis            - 畸形形成
rainfall            - 降雨量
Tremella            - 胶菌属(白木耳菌属)(担)
yeast            - 酵母﹝菌﹞
yeast            - 酵母菌
terrace            - 阶地;台地
conjugation            - 接合
Zygosaccharomyces            - 接合酵母菌属
switching            - 接通
Rotala            - 节节菜属（千屈菜科）
prolific            - 结果甚多的;有很多后裔的
union            - 结合
tuberculosis            - 结核症;结核病
realm            - 界
violin            - 菫菜素
fimbriae            - 菌毛
pili            - 菌毛
velar            - 菌膜
pseudotype            - 假模式标本
teratology            - 畸形学
pseudomembrane            - 假膜
polarization            - 极光
ultraplankton            - 极微浮游生物
torrential            - 急流生物的
Tribulus            - 蒺藜属(蒺藜科)
Piptanthus            - 黄花木属(豆科)
poliomyelitis            - 脊髓灰质炎
Thermopsis            - 黄华属(豆科)
candida            - 假丝酵母菌，念珠菌
yellowing            - 黄化
subculture            - 继代培养;更新培养
parasite            - 寄生菌
subiculum            - 寄主植物表面﹝上﹞﹝的﹞﹝很﹞密﹝的﹞菌丝体
stylus            - 尖锥瓣
subulate            - 尖锥状
Zamiaceae            - 坚果凤尾蕉科(裸)
phosphorylation            - 加磷氧基作用
thinning            - 间拔;疏拔;疏伐;间伐
reducers            - 减少效果基因
splicing            - 剪接
quarantine            - 检疫
Salmo trutta - 褐鳟
Trachemys scripta - 巴西龟
Macaca fascicularis - 食蟹猴
A. caviae           - 豚鼠气单胞菌
systematic botany           - 植物分类学
structural botany           - 植物构造学
phylogenetic botany           - 植物系统学
microfold cell           - M细胞
Physical barrier           - 天然限制;天然障碍
stomatal aperture           - 气孔开口;孔口
plant breeding           - 植物育种
plague bacillus           - 鼠疫菌
reproductive behaviour           - 生殖行为
B. burgdorferi           - 伯氏疏螺旋体
inclusion body           - 包涵体
stearic acid           - 硬脂酸;十八酸
Streptomyces aureofaciens           - 金色链霉菌
L. acidophilus           - 嗜酸乳杆菌
titratable acid           - 可滴定酸
teichoic acid           - 磷壁酸
residual air           - 残留空气
Candida albicans           - 白假丝酵母菌
vitamin A           - 维生素甲二
vitamin A           - 维生素甲一
phosphatidic acid           - 磷脂酸
vinyl alcohol           - 乙烯醇
facultative anaerobe           - 兼性厌氧菌
nucleoside analogue           - 核苷类似物
specific activity           - 特异活动性
nucleotide analogue           - 核苷酸类似物
vertical axis           - 垂直轴
sporo-pollen analysis           - 孢粉分析
vitamin B           - 维生素乙t
variance analysis           - 变方分析
vitamin B           - 维生素乙三
neutralizing antibody           - 中和抗体
vitamin B           - 维生素乙十
vitamin B           - 维生素乙十三
phthalic acid           - 苯二甲酸
P. aeruginosa           - 铜绿假单胞菌
Stone Age           - 石器时代
succinic acid           - 琥珀酸;丁二酸-[1，4]
hemorrhagic fever with renal syndrome        - 肾综合征出血热
X-ray absorption           - X线吸收
rice bran oil          - 米糠油
Pseudolarix kaempferi Gord.          - 金钱松;金松
rate of growth          - 生长速度
sucrose density gradient centrifugation         - 蔗糖浓度差离心分离
rate of fertilization          - 受精速度;受精速率
theory of evolution          - 演化论;进化论
卵壳腺  - nidamental gland
卵丘  - ovarium mound
embryo - 胚胎
sink - 壑
terpene - 萜
terpenoid - 萜类化合物
prophyll - 先出叶
promycelium - 先菌丝
gland - 腺[体]
correlation - 相关[性]
coumarin - 香豆素
response - 响应
phototropism - 向光性
tropism - 向性
tunica - 小包薄膜
purse - 小包袋
pedicel - 小柄
floret - 小花
bulblet - 小鳞茎
spikelet - 小穗
microphyll - 小型叶
leaflet - 小叶
plantlet - 小植物
columella - 小柱
microsporogenesis - 小孢子发生
microspore mother cell - 小孢子母细胞
synergism - 协同作用
stress - 胁迫
carpel - 心皮
vascular cylinder - 维管柱
pit - 纹孔
torus - 纹孔塞
pitting - 纹孔式
ornamentation - 纹饰
agravitropism - 无向重力性
physical barrier - 物理障碍
sucker - 吸根
imbibition - 吸涨[作用]
imbibition water - 吸涨水
savanna - 稀树草原
Hill reaction - 希尔反应
axis - 体轴
natural product - 天然产物
assimilate - 同化[产]物
assimilation - 同化[作用]
enation - 突起
depolarization - 脱极化
abscission - 脱落
exocarp - 外果皮
exodermis - 外皮层
ectomycorrhiza - 外生菌根
exarch - 外始式
explant - 外植体
Polyporaceae            - 多孔菌科(菌蕈目);猢狲座蕈科
tentacle            - 触手;触须
spread            - 传布;蔓延;展开
prolate            - 长球形
transmission            - 传达;传递
pollination            - 传粉作用;授粉
tropine            - 颠茄酚
potential            - 电位
Zostera            - 大叶藻属(眼子菜科)
Potentiometer            - 电位计
streptokinase            - 蛋白质分解酵素之一
voltage            - 电压
polyploidy            - 多倍性;倍数性
vasa            - 导管
wilting            - 凋萎
pleomorphism            - 多形性;多态性
regulation            - 调节;调整;节制
pistillate            - 雌蕊的
tandem            - 串行
Stagonospora            - 长穗菅茅斑叶病菌属(不)
traumatic            - 创伤的
rosetting            - 丛叶;簇叶
rosette            - 丛叶基生基;着地丛叶型;莲座型;丛生叶;叶丛
presence            - 常存度;出现率
stout            - 粗大的
unisexual            - 单性的
vernal            - 春天的;晚春
topography            - 地势;地形学
ruber            - 纯红毛
topographical            - 地形的;地方分布的
promotion            - 促进作用
potting            - 钵植
sowing            - 播种
profile            - 侧形
Psoralea            - 补骨脂属(豆科)
stratified            - 成层的
unequal            - 不等的
subunit            - 次级单位
ruminate            - 不规则地;明暗交错的
prickle            - 刺;针
Sphenophyllum            - 叉叶蕨属
X            - X线照射后第二代
tegmentum            - (包围在芽上的)鳞片层
prairie            - (北美中西部的)大草原
vaccination            - 1.(防疫苗)接种[法]2.种[牛]痘[法]
polyploidization            - (染色体)多倍体化
tapetum            - 1.(蕨类胞子囊内部)营养层2.(花药内部)营养层;3.(胚囊外的)营养层
total bacterial count          - 细菌聚落总数
 polypeptide chain          - 多肽链;多胜链
 Thlaspi arvense L.         - 退蓝菜(救荒);菥蓂(P)(Br)
Phoma - 桑胴炫f菌属（不）
phasing - 相
phenolate - 酚化物
phenolic compounds - 酚类化合物
phenotypic plasticity - 表现型可塑性
phage typing - 噬菌体型类别法
pharmaceutical - 药学的；药物
phase plate - 位相板
phase response curve - 相反应曲线
Phaseolus - 菜豆属（豆科）
Pertusaria - 疣苔属（地衣）
pest - 害虫；为害生物
Peucedanum - 前胡属（伞形花科）；土当归属
pH value - ~64_60~标值；酸度
Phacelia - 钟穗花属（杜赓生）
peritrichous - （细菌之）全面有鞭毛的
permeability coefficient - 透过系数
permeate - 透过；通过
Peronospora - 墓卜露菌病菌属
peroxide - 过氧化物酶
perpendicular - 垂直的
persistence - 残存率
persistent - 残存的；宿存的
personate - 假面状的
perfect - 完全的；具有雌蕊雄蕊的
perfoliate - 叶抱茎
pericycle - 周鞘；轴幕
periderm - 栓皮；周皮层
peripheral - 周围的；形成周边的；离开中心的；向表面的
periphery - 周围；周边
Penicillium notatum - 青霉
pepsin inhibitor - 胃液素抑制者
peptide - &#32957;
peptide chain - &#32957;键
peptone - 蛋白~64_41~；~64_41~
perceptibility - 感受性度
pellet - 片状沈淀物
pellicle - （绿虫藻的）外膜
pen - 叶中的肋
pendant - 悬垂的
penetration - 穿入；穿通
penicillin - 青霉素；盘尼西林
Penicillium - 青霉〔菌〕属
Penicillium crustaceum - 甲壳状青霉
p-coumaric acid - P—香豆酸
pectate - 凝胶质
pectinate - 栉齿状的
pedate - 鸟足状（复叶）；鸟足状分裂
peduncle - 总花梗；穗梗
peg - （子房延长而形成的）果柄
xylem - 木质部
platycodin - 桔梗皂苷
stem - 茎
stem apex - 茎端
stem flow - 茎流
crystal - 晶体
sperm cell - 精细胞
essential oil - 精油
antheridial cell - 精子器细胞
cold injury - 冷害
pome - 梨果
historical development - 历史发育
stocking - 立木度
falx - 镰形能育丝
secoiridoid - 裂环烯醚萜类化合物
archegonium - 颈卵器
quiescent center - 静止中心
trabeculae - 径列条
net production - 净生产量
inulin - 菊粉
cyme - 聚伞花序
polyketide - 聚酮化合物
tomentose - 具多数假根的
tendril - 卷须
evenness index - 均匀度指数
sclerotium - 菌核
trama - 菌髓
thallus - 菌体
Leymus Chinensis - 羊草
xylem ray - 木射线
geographic range - 地理[的]范围
geographical isolation - 地理[的]隔离
Geotrichum - 土毛菌属（不）
genetic map - 基因图
genetic marker - 遗传标识物
genetic progress - 遗传性[的]进步
genetic regulation - 遗传性[的]调节
genetic variance - 遗传变方
germ - 微生物；细菌；芽胞；胚；胚芽；种子
Gelsemium - 胡蔓藤属;黄素馨属（药典）
gemma - 胞芽；无性芽
gene expression - 基因表现
genital - 生殖的；生殖器的
genotype frequency - 基因型比率
garden variety;cultivar; cv. - 园艺品种;栽培品种
gasolene - 汽油;石油醚
generate - 生殖；生产
genetic analysis - 遗传分析
Gastrochilus - 袋舌兰属(兰科)
Gastrodia elata Blume - 天麻(梦溪笔谈);甄权药性论);赤箭(论);赤箭(芝，定风草(药性本草);独摇芝;离母;合离草;神草;鬼督邮(兰科)
soleus muscle - 比目鱼肌
arm - 臂
brachial plexus - 臂丛
flagellum - 鞭毛
communal - [同代]建巢群
synonym - [同物]异名
chief cell - [胃腺]主细胞
bone - [硬]骨
r-extinction - r 灭绝
metatarsal bone - ●骨
dwarf male - 矮雄
leucoplast - 白色体
macula - 斑
plate - 板(龟鳖类)
callose - 板鳞(蜥蜴类)
companion species - 伴生种
valve - 瓣
omasum - 瓣胃
semicircular canal - 半规管
hemidesmosome - 半桥粒
brackish water - 半咸水
club - 棒形骨针
鬃  - bristle
首科  - super-family
纵肌  - longitudinal muscle
足刺  - aciculum
足丝腺  - byssus gland
组  - series
A cell - A 细胞
B lymphocyte - B 淋巴细胞
C cell - C 细胞
T lymphocyte - T 淋巴细胞
[protective] mimicry - [保护性]拟态
rhoptry - 棒状体
[animal] society - [动物]社群
realm - [动物地理]界
synopsis - [分类]纲要
acclimatization - [风土]驯化
suture - [骨]缝
clutch size - [满]窝卵数
bill - [鸟]嘴
Nostoc - 念珠藻属（蓝）
Notching - 缺刻
N-terminus - （遗传翻译之）N-煞尾
nitrogenous base - 含氮碱
nitrophenols - 硝基酚
nitrosyl - 亚硝基
nitrous - 1.一价氮或三价氮的2.亚硝酸的
Nitzschia - 杼形硅藻属
nodal - 有节的
binocular vision - 双眼视觉
bleb - 泡
aortic arch - 大动脉弓(弧)
aortic root - 主动脉根
aponeurosis - 肌腱膜
apophysis - 脊椎突
aqueous humor - 水样液
arteries - 动脉
arterioles - 支动脉
astaxanthin - 虾红色素(鲑)
atrium - 心房
auditory nerve - 听觉神经
auricle - 心耳
autogamy - 目体受精
albinos - 白化体
aldosterone - 醛醣类固醇
allogamy - 异体受精
allotype - 异型
amino acids - 胺基酸
ammonia - 氨
anal region - 臀部
analogy - 同功
androgen - 雄性激素
angiotensin - 血管收缩
angle - 角
angular - 隅骨
angular resolution - 角分辨率
acclimation  - 驯化
acclimatization - 驯化
acetylcholine - 乙酰胆碱
acetylcholinesterase - 乙酰胆碱脂
actin - 肌原纤维
adrenal gland - 肾上腺
adrenal medulla - 肾上腺髓部
adrenaline - 肾上腺素
advanced character - 特化形质
annual rings - 年轮
antagonists - 拮抗物
antibodies - 抗体
anus - 肛门
aorta - 主(大)动脉
age composition - 年龄组成
ageing - 老化
air passage - 气道
abdomen - 腹部
abdominal cavity - 腹腔
abnormal  - 反常的
absorption efficiency - 吸收效率
physiological differentiation           - 生理(的)背腹性
terminal differentiation           - 最后分化
mesquite - 牧豆树〔属〕1.Prosopis属的有刺灌木2.Prosopis chilensis
metabolism - 〔新陈〕代谢〔作用〕
membrane system - （由单膜或双膜构成的）膜层系统
membrane transport - 薄膜传送
mentum - 兰花蕊柱基部〔的〕突出部
Megaphyton - 大叶蕨属（化石）
melanosis - 黑变症
melanosome - （涡鞭毛藻类单眼中的）黑色素块；黑素体
Roundup - 农达［一种除草剂］
posterior            - 后;向后
Pseudomonadaceae            - 假单胞菌科
Plasmodiophora            - 甘蓝根瘤病菌属(黏)
Pseudomonas            - 假单胞菌属
Ternstroemia            - 厚皮香属(山茶科)
Pseudomonas            - 假单胞菌属;帚形单胞菌属
regress            - 回归;恢复原状
pollinarium            - 花粉团
tracheid            - 假导管;管胞
Zanthoxylum            - 花椒属(芸香科)
Treponema            - 回归热梅毒病原细菌的一属
regreening            - 回青;回绿
winding            - 回旋;缠绕
turnover            - 回转;转变
stylar            - 花柱内的;花柱上的
torula            - 假酵母之一
probability            - 机率
pseudohypha            - 假菌丝
stratification            - 积层;层化;层积埋藏法
Platycarya            - 化香树属(胡桃科)
substratum            - 基层
reductase            - 还原酶
genotype            - 基因型
topology            - 风土调查;地形研究;位相学;地势学
photoperiod            - 光周〔期〕
Uncaria            - 钩藤属
photon            - 光子
photometer            - 光度计
Rhizopus            - 黑霉菌;中国曲菌属
Ustilago            - 黑穗病菌属
Terminalia            - 诃子属;榄仁树属(使君子科)
photolysis            - 光分解作用
superior            - 高的;上部的;上向的;子房上位的
sulfonyl            - 磺酰基;磺基
valence            - 价;效价
radiation            - 辐射;放射
rhizobia            - 根瘤菌
ramify            - 分枝
radiate            - 辐射的;有舌状花的
ramification            - 分枝;分枝法;分枝状态
Rhizobium            - 根瘤菌属
前神经孔  - anterior neuropore
前庭沟  - vestibular groove
前幽门孔  - prosopyle
原淋巴母细胞  - prolymphoblast
前直肌  - anterior rectus muscle
前中眼  - anterior median eye
漂鸟  - wandering bird
栖血的  - sanguicolous
鳍  - fin
鳍式  - fin formula
鳍条  - fin ray
气味腺  - scent gland, odoriferous gland
前背侧板  - prozonite
salina - 藻
bufo - 蟾蜍
alligator - 扬子鳄
microtus - 田鼠
anabaena - 鱼腥藻，鱼腥草
magnoliaceae - 木兰科
费洛蒙作用区  - active space
重复芽  - duplicate bud
子宫肌膜  - myometrium
自律性  - automaticity
自然发生  - abiogenesis, autogeny
天择  - natural selection
自体感染  - autoinfection
自营性生物  - autotroph
帚体  - phoront
昼夜节律  - day-night rhythm, circadian rhythm
皱襞  - plica
主观异名  - subjective synonym
主细胞  - chief cell
属  - genus
大脑导水管  - cerebral aqueduct
中央细胞  - central cell
中轴器  - axial organ
中轴索  - central chord
种间杂交  - species hybridization
种群  - species group
植   - zoophyte
指甲基质  - nail matrix
趾间腺  - interdigital gland
中肾  - mesonephros
黏液腺泡  - mucous acinus
粘液足  - mucous pad
粘着愈合  - adhesive fusion
掌  - palm [of hand]
蛰伏  - torpor
褶  - plica
针状骨针  - style
lateral membrane - 侧膜
embolus - 插入器
edge effect - 边缘效应
tonsil - 扁桃体
variety - 变种
specimen - 标本
collection - 标本收藏
surfactant - 表面活性物质
cytokinesis - 胞质分裂
cybrid - 胞质杂种
sporocyst - 胞蚴
cyst - 包囊
encystment - 包囊形成
protective membrane - 保护膜
infraciliature - 表膜下纤毛系
endangered species - 濒危种
vitreous body - 玻璃体
scyphistoma - 钵口幼体
predator - 捕食者
incomplete metamorphosis - 不完全变态
satellite cell - [神经节]卫星细胞
latissimus dorsi muscle - 背阔肌
lorum - 背桥
capsule - 被膜
nasal bone - 鼻骨
paranasal sinus - 鼻旁窦
comparative anatomy - 比较解剖学
soleus muscle - 比目鱼肌
arm - 臂
brachial plexus - 臂丛
flagellum - 鞭毛
communal - [同代]建巢群
synonym - [同物]异名
chief cell - [胃腺]主细胞
bone - [硬]骨
r-extinction - r 灭绝
metatarsal bone - ●骨
dwarf male - 矮雄
leucoplast - 白色体
macula - 斑
plate - 板(龟鳖类)
callose - 板鳞(蜥蜴类)
companion species - 伴生种
valve - 瓣
omasum - 瓣胃
semicircular canal - 半规管
hemidesmosome - 半桥粒
brackish water - 半咸水
club - 棒形骨针
鬃  - bristle
mantle - 上背(鸟)
superior colliculus - 上丘
maxillary tooth - 上颌齿
swarm - 群游
chevron - 人字颚
ligament - 韧带
villus - 绒毛
chorion - 绒毛膜
wattle - 肉垂
comb - 肉冠
spadix - 肉穗
lappet - 肉裾
breast - 乳房
lacteal - 乳糜管
papillary muscle - 乳头肌
papilla - 乳突
mammary gland - 乳腺
chondrocyte - 软骨细胞
parotid gland - 腮腺
gill lamella - 鳃瓣
盐生阶段演替  - halosere
眼  - eye
消化循环腔  - gastrovascular cavity
胸腺  - chest gland
雄性先熟雌雄同   - protandrous hermaphrodite
雄原核  - male pronucleus
休眠子  - dormozoite, hypnozoite
嗅毛  - olfactory hair
下目  - infra-order
下前锥  - paraconid
下鳃骨  - hypobranchial bone
心区  - cardiac region
心输出量  - cardiac output
新科  - new family, fam. nov.
陷丝  - trapline
吸泡  - alveolus
吸收细胞  - absorptive cell
习惯化  - habituation
习性  - habit
细胞集合  - cell aggregation
细胞间质  - intercellular substance
下下锋  - hypoconulid
resin - 树脂
bound water - 束缚水
fascicular cambium - 束中形成层
senescence - 衰老
phelloderm - 栓内层
frost - 霜冻
binomial nomenclature - 双名法
double fertilization - 双受精
anastomosis - 网结[现象]
叉杆骨片  - eutaxiclad
产卵、排放配子、排放幼体  - spawning
肠  - intestine
肠沟  - typhlosole
肠腔法  - enterocoelic method
肠体腔  - enterocoel
巢处  - rookery
巢寄生  - brood parasitism, inquilinism
潮溪  - tidal creek
成束茎  - fascicled stem
血管母细胞  - angioblast
持久性  - persistence
齿槽装置  - tooth-socket device
补偿作用  - compensation
补遗  - addenda 
槽板  - socket plate
壁层  - parietal layer
臂  - arm
边缘刺  - marginal spine
扁桃腺  - tonsil
侧针  - lateral stylet
抱卵肢  - oostegopod
贝壳  - conch, shell
贝壳素  - conchiolin
备雄  - complemental male
背侧褶  - dorsolateral fold
背器  - dorsal organ
背腕板  - dorsal arm plate
鳔  - swim bladder
螯肢  - chelicera
半板  - demi-plate
半规管  - semicircular canal
背须  - dorsal cirrus
鼻囊  - nasal capsule
鼻腔  - nasal cavity
瓣  - valve
棒状骨针  - strongyle
包体  - cystid
包蜕膜  - capsular decidua
孢堆果  - sorocarp
胞咽  - cytopharynx
胞饮作用  - pinocytosis
集团  - aggregate
盲囊、盲管  - diverticulum
室间孔  - interventricular foramen
可塑性  - plasticity
克氏细胞  - Clara cell
空个   - kenozooid
孔细胞  - porocyte
mucous cells - 黏液细胞
mucus - 黏液
Müller cell - 缪氏细胞
multipolar - 多极性
muscle cells - 肌肉细胞
muscle spindles - 肌束，肌梭
muscle tonus - 肌紧张
alveolus - 腔窝
theca - 鞘
bonding - 亲键
kinship - 亲缘关系
hypothalamus - 丘脑下部
saccule - 球囊
spherical colony - 球形群体
saccule - 球状囊
courtship - 求偶
stereotaxis - 趋实性
taxis - 趋性
sampling - 取样
dedifferentiation - 去分化
enucleation - 去核
migration - 迁飞
immigration - 迁入
migration - 迁徙
migrant - 迁徙动物
forearm - 前臂
foregut - 前肠
anterior chamber - 前房
frontal - 前面
canine tooth - 犬齿
ecotone - 群落交错区
community composition - 群落组成
colony - 群体
vestibule - 前庭器
方鳞  - square scale
方言  - dialect
飞航  - ballooning
非降解性  - nondegradation
肺  - lung
肺门  - hilum of lung
颚头  - gnathocephalon
耳舟  - scaphe
耳状骨  - auricle
二化  - divoltine
二头肌  - biceps muscle
翻颈部  - introvertere, introvert
生殖潜力  - biotic potential, reproductive potential
隐不动关节  - cryptosyzygy
营养个 、营养体  - gastrozooid
营养细胞  - trophoblast
one cell stage - 单细胞期
ocellus - 单眼
monophyletic - 单元的
fresh water - 淡水
elastin - 弹性蛋白
navigation - 导航
mentum - 唇基节
estrogen - 雌激素
female gamete - 雌配子
spine - 刺
stimulating factor - 刺激因子
secondary productivity - 次级生产力
bushy - 丛状分枝
androgenic gland - 促雄性腺
survivor - 存活者
tegmentum - 大脑脚盖
thigh - 大腿
persistence - 持久性
dentary bone - 齿骨
cement - 齿骨质
tooth crown - 齿冠
slit - 齿裂
dental pulp - 齿髓
dentine - 齿质
ulna - 尺骨
primary production - 初级生产[量]
primary productivity - 初级生产力
prenatal - 出生前
osculum - 出水口
reservoir - 储蓄泡
crutch - 叉头骨针
fecundity - 产卵力
field - 场
field gradient - 场梯度
common species - 常见种
palpal organ - 触肢器
home range - 巢域
urbanization - 城市化
osteoblast - 成骨细胞
myoblast - 成肌细胞
ooblast - 成卵细胞
maturation - 成熟
adult - 成体
林地偶栖生物  - patoxene
潘氏孔  - Panizza's pore
耐性  - tolerance, hardiness
泡层  - calymma
泡心细胞  - centroacinar cell
胚胎期  - embryonic stage
配子母细胞配合  - gamontogamy
peritrichous - （细菌之）全面有鞭毛的
permeability coefficient - 透过系数
permeate - 透过；通过
Peronospora - 墓卜露菌病菌属
peroxide - 过氧化物酶
perpendicular - 垂直的
persistence - 残存率
persistent - 残存的；宿存的
personate - 假面状的
perfect - 完全的；具有雌蕊雄蕊的
perfoliate - 叶抱茎
pericycle - 周鞘；轴幕
periderm - 栓皮；周皮层
peripheral - 周围的；形成周边的；离开中心的；向表面的
periphery - 周围；周边
Penicillium notatum - 青霉
pepsin inhibitor - 胃液素抑制者
peptide - &#32957;
peptide chain - &#32957;键
peptone - 蛋白~64_41~；~64_41~
perceptibility - 感受性度
pellet - 片状沈淀物
pellicle - （绿虫藻的）外膜
pen - 叶中的肋
pendant - 悬垂的
penetration - 穿入；穿通
penicillin - 青霉素；盘尼西林
Penicillium - 青霉〔菌〕属
Penicillium crustaceum - 甲壳状青霉
p-coumaric acid - P—香豆酸
pectate - 凝胶质
pectinate - 栉齿状的
pedate - 鸟足状（复叶）；鸟足状分裂
peduncle - 总花梗；穗梗
peg - （子房延长而形成的）果柄
pelagic - 外洋性的
participate - 分配
particle - 微粒；粒子
partition - 深裂片，分割
partner - 配偶体
patella - 圆形子囊球
paternal - 父方的
pathogenesis - 病的演变
pathogenic bacteria - 病原细菌
pathogenic fungi - 病原菌
pathogeny - 病原学
paraxial - 沿生物体的主轴排列的
parent family - 亲本家族
parentage - 家系；血统
parietal - 壁膜的，侧壁的
fluctuation test - 渐变测验
fluorescein - 荧光素；萤红素
fluvial - 河生的；河流作用的
Fokienia - 福建柏属（柏科）
flavone - 黄~59_１~酮
flavonol - 黄~59_１~醇
fleshy - 柔软多汁的
flex - 弯曲
flocculation - 沉淀；胶体微粒集合成块而沉淀
flood - 泛滥平原
flooding - 浸水
floral formula - 花式
xiphoid            - 剑形的
vignin            - 豇豆球蛋白
reducer            - 还原者;还原剂
teratogenesis            - 畸形形成
rainfall            - 降雨量
Tremella            - 胶菌属(白木耳菌属)(担)
yeast            - 酵母﹝菌﹞
yeast            - 酵母菌
terrace            - 阶地;台地
conjugation            - 接合
Zygosaccharomyces            - 接合酵母菌属
switching            - 接通
Rotala            - 节节菜属（千屈菜科）
prolific            - 结果甚多的;有很多后裔的
union            - 结合
tuberculosis            - 结核症;结核病
realm            - 界
violin            - 菫菜素
fimbriae            - 菌毛
pili            - 菌毛
velar            - 菌膜
pseudotype            - 假模式标本
teratology            - 畸形学
pseudomembrane            - 假膜
polarization            - 极光
ultraplankton            - 极微浮游生物
torrential            - 急流生物的
Tribulus            - 蒺藜属(蒺藜科)
Piptanthus            - 黄花木属(豆科)
poliomyelitis            - 脊髓灰质炎
Thermopsis            - 黄华属(豆科)
candida            - 假丝酵母菌，念珠菌
yellowing            - 黄化
subculture            - 继代培养;更新培养
parasite            - 寄生菌
subiculum            - 寄主植物表面﹝上﹞﹝的﹞﹝很﹞密﹝的﹞菌丝体
stylus            - 尖锥瓣
subulate            - 尖锥状
continental margin - 大陆边缘
continental shelf - 大陆架
metabolic regulation - 代谢调节
metabolite - 代谢物
basidiospore - 担孢子
monad - 单花粉
皮肤受器  - skin receptor
皮棘  - tegumental spine
皮鳃  - papula
macromolecules - 大分子
macrophage - 大噬菌体
lysogenic - 溶源的；诱导产生溶素的；诱导细胞溶解的；潜溶性的
lysozyme - 溶菌酶（细菌细胞壁黏质醣类分解酶）
M - 介值；测验均方纯度的一种介值
Macaranga - 血桐属（木戟科）
macaroni - 通心面
lurid - 蓝褐色
lutein - 1.叶黄素；2.黄体素
lux - 公尺烛光（光度单位）；米烛光
lysate - 溶解产物；溶菌液
lyse - 溶解；溶化
lysin - 溶胞素；溶素
lorate - 舌状的
lubricate - 光滑的
luciferase - （萤火虫）发光酶
lugs. - （烟草的）下部叶
Lumen - 内腔；细胞腔
luminosity - 明度；亮度
lunar cycle - 月运周期
lyase - 解离酶
Lycogala - 网灰霉属（黏）
long range - 长列
lowland rice - 低地水稻
locality - 产地；地域
localization - 局限性
loessial soil - 风积土
loment - 分节荚果
Lonas - 非洲雏菊属（菊科）
Litchi - 荔枝属（无患子科）
Litsea mollifolia Chun - 毛叶木~64_49~子；木~64_49~子；香桂子；狗胡椒
litter - 地面落叶泄K
living body - 生活体；生物体
living material - 生活物质
living tissue - 活组织
loaf sugar - 棒糖
lobation - 缺刻
lobed - 浅裂的
lobular - 小叶的；如小叶的；小裂片的
linseed - 亚麻仁；亚麻子
Pluchea            - 阔苞菊属(菊科)
wax            - 蜡
tyrosine            - 酪胺酸(酥胺酸;贝他对-羟苯基阿伐胺基丙酸;阿伐胺基一对一羟基氢化桂皮酸)
Tripterygium            - 雷公藤属(卫矛科)
Rhynia            - 雷尼蕨属(泥盆纪)
purity            - 精选度;清洁度;纯度
virescence            - 开始变成绿色
sperm            - 精子(动物);精核(植物)
antitoxin            - 抗毒素
unilateral            - 靠在一边的
coxsackievirus            - 柯萨奇病毒
transmissible            - 可传染的;可遗传的
susceptible            - 可感染性
static            - 静止的;平衡的
reducible            - 可还原的
tartar            - 酒石
theobromine            - 可可碱
Platycodon            - 桔梗属
reversible            - 可逆性的
viable            - 可生长发育的;效配子
plastic            - 可塑的;可改变的
Klebsiella            - 克雷伯菌属
torus            - 孔阜;(孔膜中的)圆节;花托
spur            - 距;(萼或花瓣的)中空[作]尾状[的]部[分]
rainfall intensity           - 降雨强度
chronic infection           - 慢性感染
surface layer           - 表层
latent infection           - 潜伏感染
vegetative growth           - 营养生长
plaque formation           - 空斑形成
plant formation           - 植物群系
radio frequency           - 放射频率
plant hormone           - 植物激素
stomatal index           - 气孔指数
refractive index           - 屈折率
triple helix           - 三重螺旋
radiation injury           - 放射伤害
vacuum filter           - 真空泸器
plant growth           - 植物生长
spontaneous generation           - 自然发生
population growth           - 族群成长
starch granule           - 淀粉粒
population genetics           - 族群遗传学
reduced form           - 还原型
tropical grasses           - 热带禾草类;暖地牧草类
multiple drug resistance          - 多重耐药
aspergillus flavus           - 黄曲霉
protoplast fusion           - 原生质体融合
specific gravity           - 比重
prosthetic group           - (酵素的)辅成基;(酵素中的)非蛋白质(的)部份
Phyllachora            - 矢竹斑叶病菌属（囊）
trimethylamine            - 三甲胺
ray            - 射髓;放射状组织;芒状髓
umbrella            - 伞膜;菌伞
test            - 试验;体壳;甲壳
Syzygium            - 蒲桃属;赤楠属(桃金娘科)
Pliny            - 普林尼
Pteroceltis            - 青檀属(榆科)
plaque            - 溶菌斑
lysozyme            - 溶菌酶
trilateral            - 三边的
hemolysin            - 溶血素
tannase            - 鞣酸酯酶;单宁酶
botulin            - 肉毒毒素
ternate            - 三出的
tripeptide            - 三肽类;三缩胺酸
triose            - 三碳糖;丙糖
Taxodiaceae            - 杉科
triiodothyronine            - 三碘甲状腺素
regionalisation            - 区域化
regionality            - 区域性
vulgar            - 普通的
Lactobacillus            - 乳杆菌属
Papillomavirus            - 乳头瘤病毒属
syngenesis            - 群落演替;群落发生
staining            - 染色
proteolysis            - 朊水解;蛋白质水解
Stephanotis            - 切舌草属(萝摩科)
pungent            - 锐尖的
Sphaeropsidales            - 茄斑叶病菌目
Phyllosticta            - 茄斑叶病菌属(不)
plantation            - 企业栽培
invasiveness            - 侵袭力
pyrogen            - 热原质
volume            - 容积;容量
urease            - 尿毒酶
porometer            - 气孔开度计
pitcher            - 囊状叶;瓶状叶
polarography            - 偏光谱分析
prostrate            - 匍匐的;伏(在)地(上)的
torsion            - 扭转
runner            - 匍匐茎;走茎
Uncinula            - 葡萄白澁病菌属
raisin            - 葡萄干
wine            - 葡萄酒
potentiality            - 潜能;可能性
Polybotrya            - 葡萄囊蕨属
Staphylococcus            - 葡萄球菌
staphylococcal            - 葡萄球菌的
phototactic            - 趋旋光性的
photocontrol            - 光控制
Tongoloa            - 红花芹属(伞形花科;香芹科)
lymphocytes - 淋巴球
lysosome - 微溶体
macrophages - 巨噬细胞
macula - 色斑
macula densa - 致密胃斑肾
male - 雄性
male sex hormone - 雄性激素
malleolus - 踝
mating - 交配
matrix - 基质
maxilla - 上颌骨
mesentery - 肠系膜
mesoderm - 中胚层
mesonephros - 中肾
metamorphosis - 变态
metanephros - 后肾
infraorbital - 眶下骨
ingroup - 内群
inhibition - 抑制作用
inhibitory - 抑制
integration - 整合作用
integument - 皮，体被
intercellular fluid - 细胞间液
intercellular substance - 细胞物质
internal environment - 体内环境
internal secretion - 内分泌
horizontal plane - 水平面
hump - 驼背
hyaline cartilage - 透明软骨
hydrofoil - 水翼
hyoid - 舌，Y形的
hyperpolarization - 过极化
hypertrophy - 过肥
intertemporal - 颞间骨
intestinal epithelium - 肠上皮
intestinal tract - 肠管
intestine - 肠
gonads - 性腺，生殖腺
gonial - 棱骨
granular cells - 颗粒细胞
granulocytes - 粒细胞
granulosa - 颗粒
gray matter - 灰质层
groove - 沟
growth - 生长
growth hormone - 生长激素
guanine - 鸟粪嘌呤，鸟粪碱
gums - 树胶，胶质
共居性  - synanthropic
晶状体泡  - lens vesicle
精子  - sperm, spermatozoon
精子凝集素  - sperm-agglutinin
精细胞  - spermatid
科  - family
壳  - corona, shell
壳盖  - operculum
荐椎  - sacral vertebra
交接管  - copulatory tube
交配群集  - synhesia
交配库  - mating pool
颈翼膜  - cervical ala
寄生去势  - parasitic castration
颊  - cheek
颊线  - cheek stripe, malar stripe
角膜缘  - corneal limbus
角质鳍条  - ceratotrichia
铰合部  - hinge
接合后体  - exconjugant
节体  - segmenter
节细胞层  - ganglion cell layer
肌皱丝  - myophrisk
间质生长  - interstitial growth
肩峰突  - acromion
睑板  - tarsal plate, tarsus
极管  - polar tube
极性  - polarity
棘口尾蚴  - echinostome cercaria
棘头体  - acanthella
环状胎盘  - ring placenta
寰椎  - atlas
肌  - gemellus muscle
肌槽  - muscular socket
肌带  - muscle strand
肌隔  - myocomma
肌膜  - sarcolemma
肌肉  - muscle
后锥  - metacone
后腕  - posterior arm
后吸盘  - posterior sucker
后嗅检器  - aboral osphradium
后眼列  - posterior row of eyes
弧胸型  - arcifera
护器  - tutaculum
跗  - ankle
前闭壳肌  - anterior adductor muscle
前鞭毛体  - promastigote
前牙堤  - promargin
前盔  - frontal shield
fungicidal - 杀菌的
fungoid - 似丝状菌的
fungous - 海绵状或质地似丝状菌的；生长快速似丝状菌的
funnel - 苹科植物大孢子外衣的下部
frond - 蕨〔类的〕叶；棕榈〔类的〕叶；若干藻类的宽平的叶；青萍的似叶状体的茎
fructiferous - 有果实的
fructokinase - 使果糖的C-1位置磷化的激活酶
fructose-1，6-diphosphate - 果糖-1，6-二磷酸
frugivorous - 吃果实的
fruiting - 结果
hostility - 敌对作用
house plant - 室内植物
homozygosity - 同型接合性
homogeneity - 同构型
homogeneous - 同质的;均质的;纯一的;同形的
homogenizer - 匀浆制造器
hops - 干蛇麻;干啤酒花
hordein - 大麦蛋白
hormone - 激素; 荷尔蒙　
host resistance - 宿主抵抗性
holdfast - (1)附着器;(2)海藻的假根;(3)卷须的末端
holism - 全体论
hollowed - 空心的
homogenous - 同源的;同质的;均一的
homologous - 同型的; 相似的
homologous series - 相同系列;相似变异系列
homomorphic - 同形的;完全花祇有一型的
Homonoia - 水柳仔属;水杨梅属(大戢科)
homopolymer - 同分子重合体
hip - (有新鲜花管围绕成熟子房的)蔷薇果
Hippophae - 沙棘属(胡颓子科)
holoenzyme - 完整酵素
holotype - 正模式标本
holt - 小树林;有森林
homocysteine - 同胱胺酸
hibernation - 冬眠;越冬
histogram - 柱形图;矩形图
hit - 冲击
heterotroph - 异养生物;有机营养;寄生营养;他养
heterozygosity - 异型接合度
high hydraulic pressure - 高级水压
high quality - 高级质量;优良质量
hilling - 土堆法
hilum - (种子的)脐;(花粉外被的)孔;珠柄痕迹;淀粉位同心层的稠密部
heteromorphism - 异形性
Vibrio            - 弧菌属
Rhodiola            - 红景天属(景天科)
yellows            - 黄疽病
stone            - 核(核果的坚硬的内果皮)
prodigiosin            - 红色杆菌红素;灵菌红素
angular resolution - 角分辨率
acclimation  - 驯化
acclimatization - 驯化
acetylcholine - 乙酰胆碱
acetylcholinesterase - 乙酰胆碱脂
actin - 肌原纤维
adrenal gland - 肾上腺
adrenal medulla - 肾上腺髓部
adrenaline - 肾上腺素
advanced character - 特化形质
annual rings - 年轮
antagonists - 拮抗物
antibodies - 抗体
anus - 肛门
aorta - 主(大)动脉
age composition - 年龄组成
ageing - 老化
air passage - 气道
abdomen - 腹部
abdominal cavity - 腹腔
abnormal  - 反常的
absorption efficiency - 吸收效率
Cephalotaxaceae - 三尖杉科
Cephalotaxus - 三尖杉属
鬣鳞  - crest scale
磷酸型外壳(腕足动物)  - phosphatic type
菱形体  - rhombogen
老年体  - senile
透明幼   - puerulus larva
绿带  - green belt
卵黄  - yolk
卵黄分裂  - yolk cleavage
类骨质  - osteoid
梨状叶  - pyriform lobe
离巢雏  - fledgling
连孔  - communication pore
裂冠型触手冠  - schizophorus lophophore
裂体腔法  - schizocoelic method
合巢群集  - synoecium
合纤毛  - syncilium
河口  - estuary
核二型性  - nuclear dualism
核周质  - perikaryon
有颌类  - gnathostomata
冠海胆型  - diadematoid type
横桥  - cross bridge
横纹面  - striated area
后肾  - metanephros
后凹椎体  - opisthocoelous centrum
共表型的  - cophenetic
lysate - 溶解产物；溶菌液
lyse - 溶解；溶化
lysin - 溶胞素；溶素
lorate - 舌状的
lubricate - 光滑的
luciferase - （萤火虫）发光酶
lugs. - （烟草的）下部叶
Lumen - 内腔；细胞腔
luminosity - 明度；亮度
lunar cycle - 月运周期
lyase - 解离酶
Lycogala - 网灰霉属（黏）
long range - 长列
lowland rice - 低地水稻
locality - 产地；地域
localization - 局限性
loessial soil - 风积土
loment - 分节荚果
Lonas - 非洲雏菊属（菊科）
Litchi - 荔枝属（无患子科）
Litsea mollifolia Chun - 毛叶木~64_49~子；木~64_49~子；香桂子；狗胡椒
litter - 地面落叶泄K
living body - 生活体；生物体
living material - 生活物质
living tissue - 活组织
loaf sugar - 棒糖
lobation - 缺刻
lobed - 浅裂的
lobular - 小叶的；如小叶的；小裂片的
linseed - 亚麻仁；亚麻子
Listera - 二叶兰属（兰科）
line transect - 直线接触种类鉴定记载法
linear regression - 直线回归
lingua - 舌状构造
linin - 核丝质
linked - 连锁的
linked genes - 连锁基因
lipoic acid - 类脂酸
lipoid - 类脂体
linoleic acid - 亚麻油酸；十八碳二烯（9.12）一酸；维生素己
linolenic acid - 苏子油酸
Kummerowia - 鸡眼草属（豆科）
Ligusticum - &#34241;木属；当归属（伞形花科）
likelihood ratio - 近似比率
knot - 结；节
koji - 曲
light plant - 阳地植物
lightening - 电光照射；闪电
lignification - 木化；木质化
karyotype analysis - 核型分析
oblique muscle - 斜肌
[blood] platelet - 血小板
circulation - 循环
subadult - 亚成体
subfamily - 亚科
fauces - 咽门
halosere - 盐生演替系列
salt gland - 盐腺
multiplier effect - 延增效应
eyeball - 眼球
orbit - 眼窝
myocardium - 心肌膜
pheromone - 信息素
active space - 信息素作用区
forma - 型
morphogenesis - 形态发生
character - 性状
pleural cavity - 胸膜腔
thoracic cavity - 胸腔
androgenesis - 雄核发育
dormancy - 休眠
olfactory organ - 嗅觉器[官]
salt water - 咸水
adenohypophysis - 腺垂体
lacuna - 陷窝
limiting factor - 限制因子
coadaptation - 相互适应
compatibility - 相容性
mosaic distribution - 镶嵌分布
nape - 项
consumer - 消费者
digestion - 消化
peduncle - 小柄
hooklet - 小钩
micronucleus - 小核
olfactory bulb - 嗅球
olfactory nerve - 嗅神经
quincuncial - 五点形的
physical environment - 物理环境
species diversity - 物种多样性
apophysis - 膝状突起
genealogy - 系谱学
systematics - 系统分类学
system ecology - 系统生态学
cell lineage - 细胞谱系
astaxanthin - 虾青素
isthmus - 峡部
inferior concha - 下鼻甲
labium - 下唇
spherulous cell - 小球细胞
opium - 寄生群落
parasite - 寄生物
domestication - 家化
nail - 甲
nail plate - 甲板
keratinization - 角化
boss - 角皮凸
keratose - 角质骨骼
segment - 节
annulus - 环状部
ring stage - 环状体期
molt - 换羽
torch - 火炬形骨针
crusta - 甲壳
parathyroid gland - 甲状旁腺
parathyroid hormone - 甲状旁腺素
hindgut - 后肠
basal body - 基体
muscle tissue - 肌[肉]组织
actin - 肌动蛋白
sarcomere - 肌节
myosin - 肌球蛋白
muscle satellite cell - 肌卫星细胞
muscle fiber - 肌纤维
troponin - 肌原蛋白
sarcoplasmic reticulum - 肌质网
activation - 激活
polar filament - 极丝
polarity - 极性
cylinder - 滚轴式骨针
rod - 棍棒形骨针
metatarsus - 后跗节
bracket - 弧形骨针
rosette - 花纹样体
environmental capacity - 环境容量
supercooling - 过冷
sweat gland - 汗腺
aerobe - 好氧生物
karyokinesis - 核分裂
germinal vesicle - 核泡
karyogamy - 核配
nuclear transplantation - 核移植
melanin - 黑素
melanosome - 黑素体
tabula - 横板
trabecula - 横枝(苔藓动物)
permanent tooth - 恒齿
siphon - 虹管
coexistence - 共存
guild - 共位群
new species - 新种
nexine - （花粉膜的）中层
n-generation - n-世代
niche - 生态上的位置
nick - （核酸）链裂
nicotinamide - 烟~59_1~酰胺
nicotine - 烟~59_1~
Nitraria - 白刺属（蒺藜科）
nitrifier - 硝化菌
nitrocellulose - 硝化纤维素；火药棉
nitrogen assimilation - 氮〔素〕同化作用
nitrogen cycle - 氮气循环
neophytes - 新来植物；新来杂草
neotype - 新模式标本
nerve - 叶脉
Nigella - 黑种草属（毛茛科）
needle crystal - 针晶
needle-shaped - 针形的
negative control - 负〔的〕控制
Neocheiropteris - 扇蕨属（水龙骨科）
Neolitsea - 新木姜子属（樟科）
natural history - 博物学；自然学
natural law - 天然法则，自然律
natural population - 天然族群
natural resistance - 天然抵抗性
natural system - 自然分类系统
naturalist - 博物学者
naturalization - 归化
nature - 天然；自然界；本性
necrosis - 坏死；局部溃坏
negative value - 负值
Negundo - 复叶类（枫树）
nanism - 不正常的小型；矮型
Nanophyton - 小蓬属（藜科）
nasty - 倾性；不定向运动
natant - 浮游的
free end - （染色体之）自由端
septum - 隔板 (苔藓动物)
radix - 根部
survivor - 存活者;生还者;生存者
potato virus Y， - 马铃薯病毒Y烟草病毒Y;蕃茄病毒Y
M protein - M蛋白
preferment - 酵素原;酶原
pyrimidine - 嘧啶(二氮三烯陆圜)
Phytophthora capsici Leonian - 番椒;南瓜类疫病菌;胡瓜、西红柿灰色疫病菌;西瓜、茄褐色腐败病菌
polypeptide chain - 多肽链;多胜链
polymyxin - 多黏根菌素(在Bacillus polymyxa培养液中发现的抗菌性多钛类有A~E等)
proofreading - 改正过程
rhizosphere - 四周围绕有根的部分;根群区
rust - 锈病;锈病菌
精子  - sperm, spermatozoon
精子凝集素  - sperm-agglutinin
精细胞  - spermatid
科  - family
壳  - corona, shell
壳盖  - operculum
荐椎  - sacral vertebra
交接管  - copulatory tube
交配群集  - synhesia
交配库  - mating pool
颈翼膜  - cervical ala
寄生去势  - parasitic castration
颊  - cheek
颊线  - cheek stripe, malar stripe
角膜缘  - corneal limbus
角质鳍条  - ceratotrichia
铰合部  - hinge
接合后体  - exconjugant
节体  - segmenter
节细胞层  - ganglion cell layer
肌皱丝  - myophrisk
间质生长  - interstitial growth
肩峰突  - acromion
睑板  - tarsal plate, tarsus
极管  - polar tube
极性  - polarity
棘口尾蚴  - echinostome cercaria
棘头体  - acanthella
环状胎盘  - ring placenta
寰椎  - atlas
肌  - gemellus muscle
肌槽  - muscular socket
肌带  - muscle strand
肌隔  - myocomma
肌膜  - sarcolemma
肌肉  - muscle
后锥  - metacone
后腕  - posterior arm
后吸盘  - posterior sucker
后嗅检器  - aboral osphradium
后眼列  - posterior row of eyes
弧胸型  - arcifera
护器  - tutaculum
跗  - ankle
前闭壳肌  - anterior adductor muscle
前鞭毛体  - promastigote
前牙堤  - promargin
前盔  - frontal shield
前膜  - frontal membrane
前脑  - prosencephalon, forebrain
hyaline - 透明的
hyaluronic acid - 玻尿酸
hybrid progeny - 杂种后代
Hevea - 橡胶树属(大戟科)
hexane - 六烷;已烷
hexaploid - 六倍体;六元体
hexokinase - 六炭糖激化酶
hey - 干草
heterosexual - 异性的;异型接合性的
heterosporous - 产生异形孢子的
heterothallism - 雌雄异丝性;配子体单性
herbarium - 腊叶标本馆;植物标本馆
heterocyclic compound - 异环族化合物
heterogeneous - 异质的;不均一的
heterogenesis - (1)突然发生(Korschinsky1901);(2)世代交替(Ri-eyer et al 1954)
heritage - 遗传质;遗传性
heteranthery - 雄蕊异长现象
Hepatica - 獐耳细辛属(毛茛科)
Heracleum - 独活属(伞形花科)
herb - 草本;阔叶草本;药草
herb layer - 草本层
hemicellulose - 半纤维素;贮藏性纤维素
header - 采穗机
Helicia - 山龙眼属(山龙眼科)
Helminthosporium - 麦类胡麻叶炫f菌属
haploidy - 单倍体性;单元性
heart-shaped - 心脏形的
heat - 热能;发情期
heat balance - 热均衡
heat insulation - 保温
heat stable - 耐热的;高温安定的
Hedyotis - 凉喉茶属(茜草科)
Hela cells - 海伦郎培养细胞 ;Helen Lane夫人子宫颈癌细胞培养的细胞
haplostele - 单中心柱
hapten - 不完全抗原
hard soil - 硬土
hardening - 强化(因温低而引致的对于低温的扺抗性)
hardness - 硬度;强度
hardpan - 硬盘
harmonic - 和协环境;和协栖所
Harter - 茄褐纹病菌
Halimodendron - 盐豆木;铃铛刺;耐碱树;盐树
halo - 孔围
halophilous - 好盐性的
haploid chromosome - 单倍染色体;单套染色体
haploid plant - 单倍植物体
H&sup2; - 氚;重氢符号
H+ - 氢离子
habitat - 生境(生活环境 );栖所;产地
spherulous cell - 小球细胞
shank - 小腿
microplankton - 小型浮游生物
microspore - 小孢子
coevolution - 协同进化
cercus - 尾须
cercaria - 尾蚴
fundus - 胃底
fundic gland - 胃底腺
gastric artery - 胃动脉
caecum - 胃盲囊
gastric mill - 胃磨
gastral cavity - 胃腔
epigastrium - 胃外区
funiculus - 胃绪
inferior oblique muscle - 下斜肌
mandible - 下颌骨
ciliate - 纤毛虫
corona - 纤毛冠
loop - 腕环
cirrus - 腕丝 (腕足动物)
carpometacarpal joint - 腕掌关节
pad - 腕趾
reticulum - 网胃
reticulocyte - 网织红细胞
reticular layer - 网状层
reticular formation - 网状结构
rostrum - 吻板
proboscis - 吻突
modiolus - 蜗轴
pollution - 污染
asexual reproduction - 无性生殖
microevolution - 微[观]进化
micropore - 微孔
micronutrient - 微量营养物
microcirculation - 微循环
microfold cell - 微褶细胞
atrium - 围鳃腔
pseudocyst - 伪包囊
phasmid - 尾感器
ectoparasite - 外寄生物
exotic species - 外来种
outgroup - 外类群
mantle - 外套膜
mantle cavity - 外套腔
outer root - 外突
exite - 外叶
exogenous - 外源
ectoplasm - 外质
crura - 腕钩
interference color - 干涉色
inductive - 诱导的
inductor - 诱导者；诱导物质
induplicate - 内卷的；内向镊合状
indusium - 苞膜；囊群膜
inert - 惰性的（不活动的；生理无作用的）
infection - 接种；传染；感染
infertility - 不孕性
infestation - 传染
infiltration - 渗浸〔作用〕；浸润；渗入
infinite - 无限的
information - 信息；情报；新知；变量的倒数
inhalation - 吸入剂；吸入作用
inherent - 先天〔性〕的；内在的遗传
inhibition - 阻害；阻害作用；抑制作用
initiation - 创始作用；始发作用
innate - 先天的；遗传的；附着在支持构造顶端的
indication - 指示法；示迹
indicator - 指示药；指示剂
indifferent - 未分化的
indigo - 蓝淀（纲目）
indigo-blue - 青蓝色；青蓝；靛蓝；靛青
individuality - 个性；个体性
indophenol - 靛基酚；蓝靛酚
inducible - 可诱导的
inclusion body - 对内体
incorporation - 参入；合体；合并
incubation - 潜伏；翼覆；抱卵；孵化
incubator - 孵卵器；定温器
indehiscent fruit - 不开裂果；闭果；全面干果
independent character - 独立性状
independent variable - 自变数；自变量
fine grain - 细致纹理
firmness - 硬度；确实度
first division - 减数第一分裂
field corn - 普通玉蜀黍
filament - （细胞质的）丝状构造；花丝；丝状体
Fissidens - 凤尾藓属
fission - 分裂；二等分裂开
fissure - 深沟；深裂
fitness - 适合度；适应度；适合者
flaccid - 萎缩的
filiform - 丝状；线状
filter - 过滤器；滤器；滤过
filter membrane - 滤膜
final common pathway - 最后共同路径
trypsin inhibitor           - 胰蛋白酶抑制者
total length           - 全长
Mycobacterium leprae           - 麻风分枝杆菌
protein metabolism           - 蛋白质代谢作用
已引用  - loco laudato, loc. cit.
异型世代交替  - heterogeny
异质性  - heterogeneity
翼部  - ala
翼镜  - speculum
翼咽肌  - pterygopharyngeus muscle
阴蒂  - clitoris
眼球血管膜  - vascular tunic of eyeball
眼下齿  - suborbital tooth
演替阶段  - sere
样区  - quadrat, sample plot
腰  - rump
腰鞭毛虫孢囊  - hystrichosphere
腰带  - pelvic girdle
嚼肌  - masseter muscle
阴门  - vulva
阴门裂  - rima vulvae
指示器  - conductor
悬器  - suspensorium
血窦  - sinusoid
牙沟  - fang groove, cheliceral furrow
芽球生殖  - gemmulation
亚齿  - secondary tooth
夜间迁徙  - nocturnal migration
新属  - new genus, gen.nov.
行  - plantigrade
形态梯度  - morphocline
胸肋  - sternal rib
咽齿  - pharyngeal tooth
咽囊  - pharyngeal pouch
咽腔  - pharyngeal cavity
physiological differentiation           - 生理(的)背腹性
terminal differentiation           - 最后分化
hepatitis E           - 戊型肝炎
infectious disease           - 传染病
pot culture           - 盆植
synchronized culture           - 同调培养;同步培养
sterile culture           - 无菌培养
suspension culture           - 悬浮培养
submerged culture           - 液中培养
rooted cutting           - 插条苗
progressive development           - 渐进发育;前进发育
residual effect           - 残余效应
Poisson distribution           - 卜瓦松氏分布
cytopathic effect           - 细胞病变效应
radiation effects           - 放射效应
random distribution           - 逢机分布;随机分布
transpiration efficiency           - 蒸散效率
E. coli           - 大肠埃希菌
protective colloid           - 保护胶体
节细胞层  - ganglion cell layer
肌皱丝  - myophrisk
间质生长  - interstitial growth
肩峰突  - acromion
睑板  - tarsal plate, tarsus
极管  - polar tube
极性  - polarity
棘口尾蚴  - echinostome cercaria
棘头体  - acanthella
环状胎盘  - ring placenta
寰椎  - atlas
肌  - gemellus muscle
肌槽  - muscular socket
肌带  - muscle strand
肌隔  - myocomma
肌膜  - sarcolemma
肌肉  - muscle
后锥  - metacone
后腕  - posterior arm
后吸盘  - posterior sucker
后嗅检器  - aboral osphradium
后眼列  - posterior row of eyes
弧胸型  - arcifera
护器  - tutaculum
跗  - ankle
前闭壳肌  - anterior adductor muscle
前鞭毛体  - promastigote
前牙堤  - promargin
前盔  - frontal shield
前膜  - frontal membrane
前脑  - prosencephalon, forebrain
前神经孔  - anterior neuropore
前庭沟  - vestibular groove
前幽门孔  - prosopyle
原淋巴母细胞  - prolymphoblast
前直肌  - anterior rectus muscle
前中眼  - anterior median eye
漂鸟  - wandering bird
栖血的  - sanguicolous
鳍  - fin
鳍式  - fin formula
鳍条  - fin ray
气味腺  - scent gland, odoriferous gland
前背侧板  - prozonite
pylorus - 幽门
quadrate - 方骨
rachis - 脊柱，脊椎，主轴，齿板
rakers - 鳃耙
prolactin - 催乳激素
promyelocyte - 前髓细胞
持久性  - persistence
齿槽装置  - tooth-socket device
补偿作用  - compensation
补遗  - addenda 
槽板  - socket plate
壁层  - parietal layer
臂  - arm
边缘刺  - marginal spine
扁桃腺  - tonsil
侧针  - lateral stylet
抱卵肢  - oostegopod
贝壳  - conch, shell
贝壳素  - conchiolin
备雄  - complemental male
背侧褶  - dorsolateral fold
背器  - dorsal organ
背腕板  - dorsal arm plate
鳔  - swim bladder
螯肢  - chelicera
半板  - demi-plate
半规管  - semicircular canal
背须  - dorsal cirrus
鼻囊  - nasal capsule
鼻腔  - nasal cavity
瓣  - valve
棒状骨针  - strongyle
包体  - cystid
包蜕膜  - capsular decidua
孢堆果  - sorocarp
胞咽  - cytopharynx
胞饮作用  - pinocytosis
集团  - aggregate
盲囊、盲管  - diverticulum
室间孔  - interventricular foramen
可塑性  - plasticity
克氏细胞  - Clara cell
空个   - kenozooid
孔细胞  - porocyte
口  - mouth
口道沟  - siphonoglyph
口笠  - oral hood
口面间辐区  - oral interradial area
静脉窦  - venous sinus
居氏器  - Cuvierian organ
巨球型  - megalospheric form
据通信  - in litteris, in litt.
距  - spur, calcar
锯齿状  - spination
卷旋骨针  - sigmaspire
铠  - pallet
reflection            - 反射作用
Punctaria            - 幅藻属(褐藻)
succulent            - 多肉质的
toxemia            - 毒血症
radion            - 放射粒
dimorphic            - 二相性，双相性
radiosensitivity            - 放射敏感性
radiograph            - 放射摄影
radioisotope            - 放射同位素
radioactive            - 放射性的
symmetry            - 对称
radial            - 放射状的
symmetrical            - 对称的
zymology            - 发酵学
pylorus - 幽门
quadrate - 方骨
rachis - 脊柱，脊椎，主轴，齿板
rakers - 鳃耙
prolactin - 催乳激素
promyelocyte - 前髓细胞
prop - 支柱
propulsion - 喷出，前进器
pterin - 蝶呤
purines - 嘌呤
poison gland - 毒腺
pons - 桥脑
portal system - 门脉系
postsynaptic membrane - 后连会膜
potassium - 钾
pregnancy - 受孕
periosteum - 骨膜
peristalsis - 蠕动
peritoneum - 腹腔膜
peritrophic membrane - 围食膜
perivitelline space - 围卵隙
petrosal - 岩骨的
pharyngeal bones - 咽骨
phosphorus - 磷
photoreceptors - 光感受器
pigment epithelium - 色素上皮
primary male - 初级雄性
pancreatic polypeptide - 胰多
parallel evolution - 平行演化
parallelism - 平行现象
paraphyly - 侧系统
parathyroid gland - 副甲状腺
parenchyma - 薄壁组织
parenchyma cells - 薄壁细胞
parietal cells - 顶骨细胞
pituitary gland - 脑下垂体
mating system - 交配系
mapping - 基因线状排列作图
Marattia - 观音座莲舅属
margined - 有边缘的
maritime - 海岸的
marker - 标识
marmalade - 果酱；果胶
marshy meadow - 湿地草原
Mangifera - 檬（&#26471;）果属（漆树科）
Manglietia - 木莲属（木兰科）
Manihot - 1.树薯属（大戟科）2.参茨属
manna - 梣甘露；木蜜；欧洲白蜡树溢出液
mannase - 梣甘露酶；甘露聚糖酶
male organ - 雄性器官
male sterility - 雄不孕性
malonyl - 丙二酰基；柰酸基
maltoside - 麦芽糖苷
malty - 麦芽的；似麦芽的
Malus - 苹果属（蔷薇科）
Madia - 臭油草（菊科）
Maesa - 杜茎山属（紫金牛科）
macroscopic - 用肉眼可见的
implant - 植入；植入物
implantation - 内植；植入
implicate - 编入的；组入的；一同旋卷的
impressed - 有刻痕的
imprint - （平板培养上的）押印
in situ - 在原位上
in vitro - 在玻璃器内；在体外
in vitro - 在玻璃器内(的);在生物体外
in vitro culture - 玻璃器内培养体外培养
in vivo - 在生体内
in vivo - 在生体内[的]
inactivity - 不活动；无作用
inborn - 先天的
inbred - 近亲交配的
incandescent light - 白热光
incidence - 发生率；发病率
incipient - 端始的
imbibition - 喷浸；膨润现象
immersed - 沈浸在水中的
immersion - 浸；浸渍
immobile - 不动的
immobilization - 停滞作用
immortality - 不灭性
immunogenic - 产生免疫的；免疫性的
immunoglobulin - 免疫球状蛋白质
impacted - 嵌入的；嵌塞的
imperforate - 无孔的
impermeability - 不透过性
conidiogenous cell - 产孢细胞
long day - 长日照
matric potential - 衬质势
stratification - 成层现象
red tide - 赤潮
gibberellin - 赤霉素
primary structure - 初生结构
mentha-camphor - 薄荷脑
protective layer - 保护层
arctic realm - 北极界
prairie - 北美草原
essential element - 必需元素
tichus - 壁层
axoneme - 鞭毛轴丝
sapwood - 边材
form - 变型
stalk cell - 柄细胞
adventitious bud - 不定芽
trabecula - [腹菌]产孢组织基板
thorn - [棘]刺
stipe - [菌]柄
culm - [空心]称
spur - [枝]距
[vegetation] continuum - [植被]连续体
endothecium - [蒴]内层
p-protein - p-蛋白
dwarf plant - 矮化植物
dark respiration - 暗呼吸
campo - 巴西草原
abortion - 败育
claw - 瓣爪
Forsythia suspensa - 連翹
Torreya jackii Chun          - 长叶榧树
 stellera chamaejasme L.         - 狼毒;西北狼毒(药材学);棉大戟;山萝菔(云南)
variation of chromosome numbers         - 染色体数变异
intervertebral foramen - 椎间孔
centrum - 椎体
pyramid - 锥骨
pyramidal layer - 锥体层
pyramidal cell - 锥体细胞
table - 桌形体
nidation - 着床
trophoblast - 滋养层
tomite - 仔体
endometrium - 子宫内膜
fruiting body - 子实体
sporozoite - 子孢子
autotomy - 自切
nature management - 自然管理
naturalization - 自然化
priority - 优先权
floater - 游荡者
free end - 游离端
pest - 有害动物
cirrus - 须毛
spire - 旋转骨针
error - 学名差错
emendation - 学名订正
blood vessel - 血管
hemoglobin - 血红蛋白
lobe - 叶
delamination - 叶裂[法]
pinnule - 叶状腹叶
axillary - 腋羽
nocturnal - 夜行
genetic diversity - 遗传多样性
migration - 移行
transitional cell - 移行细胞
transplantation - 移植
ceremony - 仪表行为
susceptible species - 易危种
dissimilation - 异化
oblique muscle - 斜肌
[blood] platelet - 血小板
circulation - 循环
subadult - 亚成体
subfamily - 亚科
fauces - 咽门
halosere - 盐生演替系列
salt gland - 盐腺
multiplier effect - 延增效应
eyeball - 眼球
orbit - 眼窝
myocardium - 心肌膜
pheromone - 信息素
active space - 信息素作用区
forma - 型
morphogenesis - 形态发生
character - 性状
pleural cavity - 胸膜腔
thoracic cavity - 胸腔
androgenesis - 雄核发育
dormancy - 休眠
olfactory organ - 嗅觉器[官]
salt water - 咸水
adenohypophysis - 腺垂体
lacuna - 陷窝
limiting factor - 限制因子
coadaptation - 相互适应
compatibility - 相容性
槽板  - socket plate
壁层  - parietal layer
臂  - arm
边缘刺  - marginal spine
扁桃腺  - tonsil
侧针  - lateral stylet
抱卵肢  - oostegopod
贝壳  - conch, shell
贝壳素  - conchiolin
备雄  - complemental male
背侧褶  - dorsolateral fold
背器  - dorsal organ
背腕板  - dorsal arm plate
鳔  - swim bladder
螯肢  - chelicera
半板  - demi-plate
半规管  - semicircular canal
背须  - dorsal cirrus
鼻囊  - nasal capsule
鼻腔  - nasal cavity
瓣  - valve
棒状骨针  - strongyle
包体  - cystid
包蜕膜  - capsular decidua
孢堆果  - sorocarp
胞咽  - cytopharynx
胞饮作用  - pinocytosis
集团  - aggregate
盲囊、盲管  - diverticulum
室间孔  - interventricular foramen
可塑性  - plasticity
克氏细胞  - Clara cell
空个   - kenozooid
孔细胞  - porocyte
口  - mouth
口道沟  - siphonoglyph
口笠  - oral hood
口面间辐区  - oral interradial area
静脉窦  - venous sinus
居氏器  - Cuvierian organ
巨球型  - megalospheric form
据通信  - in litteris, in litt.
距  - spur, calcar
锯齿状  - spination
卷旋骨针  - sigmaspire
铠  - pallet
近等分裂  - adequal cleavage
共居性  - synanthropic
晶状体泡  - lens vesicle
精子  - sperm, spermatozoon
sebaceous gland - 皮脂腺
skin fold - 皮褶
amensalism - 偏害共生
frequency - 频度
parallelism - 平行进化
energy flow - 能流
fertility - 能育性
rhizoids - 拟根共肉
parasitoid - 拟寄生物
stabilimentum - 匿带
age distribution - 年龄分布
annual cycle - 年周期
bird - 鸟
ornithology - 鸟类学
urethra - 尿道
allantois - 尿囊
agglutination - 凝集[作用]
umbilicus - 脐(贝壳)
trachea - 气管
tracheal cartilage - 气管软骨
stigma - 气门
emigration - 迁出
hallux - 拇趾
order - 目
cold hardiness - 耐寒性
capsule - 囊
blastula - 囊胚
cysticercus - 囊尾蚴
meninges - 脑[脊]膜
Paneth cell - 帕内特细胞
ovulation - 排卵
egestion - 排遗
lamella - 牌板
paracrine - 旁分泌
vesicle - 泡状体(苔藓动物)
blastocyst - 胚泡
cecum - 盲肠
shaft - 锚杆
anchor - 锚形体
hair - 毛
pelage - 毛被
gyrus - 脑回
cerebrospinal fluid - 脑脊液
pons - 脑桥
involution - 内卷
atrium - 内腔
internal mammary artery - 内乳动脉
apophysis - 内突骨
endotherm - 内温动物
inner cell mass - 内细胞团
背侧褶  - dorsolateral fold
背器  - dorsal organ
背腕板  - dorsal arm plate
鳔  - swim bladder
螯肢  - chelicera
半板  - demi-plate
半规管  - semicircular canal
背须  - dorsal cirrus
鼻囊  - nasal capsule
鼻腔  - nasal cavity
瓣  - valve
棒状骨针  - strongyle
包体  - cystid
包蜕膜  - capsular decidua
孢堆果  - sorocarp
胞咽  - cytopharynx
胞饮作用  - pinocytosis
集团  - aggregate
盲囊、盲管  - diverticulum
室间孔  - interventricular foramen
可塑性  - plasticity
克氏细胞  - Clara cell
空个   - kenozooid
孔细胞  - porocyte
口  - mouth
口道沟  - siphonoglyph
口笠  - oral hood
口面间辐区  - oral interradial area
静脉窦  - venous sinus
居氏器  - Cuvierian organ
巨球型  - megalospheric form
据通信  - in litteris, in litt.
距  - spur, calcar
锯齿状  - spination
卷旋骨针  - sigmaspire
铠  - pallet
近等分裂  - adequal cleavage
共居性  - synanthropic
晶状体泡  - lens vesicle
精子  - sperm, spermatozoon
精子凝集素  - sperm-agglutinin
精细胞  - spermatid
科  - family
壳  - corona, shell
壳盖  - operculum
荐椎  - sacral vertebra
交接管  - copulatory tube
交配群集  - synhesia
交配库  - mating pool
颈翼膜  - cervical ala
Peucedanum - 前胡属（伞形花科）；土当归属
pH value - ~64_60~标值；酸度
Phacelia - 钟穗花属（杜赓生）
peritrichous - （细菌之）全面有鞭毛的
permeability coefficient - 透过系数
permeate - 透过；通过
Peronospora - 墓卜露菌病菌属
peroxide - 过氧化物酶
perpendicular - 垂直的
persistence - 残存率
persistent - 残存的；宿存的
personate - 假面状的
perfect - 完全的；具有雌蕊雄蕊的
perfoliate - 叶抱茎
pericycle - 周鞘；轴幕
periderm - 栓皮；周皮层
peripheral - 周围的；形成周边的；离开中心的；向表面的
periphery - 周围；周边
Penicillium notatum - 青霉
pepsin inhibitor - 胃液素抑制者
peptide - &#32957;
peptide chain - &#32957;键
peptone - 蛋白~64_41~；~64_41~
perceptibility - 感受性度
pellet - 片状沈淀物
pellicle - （绿虫藻的）外膜
pen - 叶中的肋
pendant - 悬垂的
penetration - 穿入；穿通
penicillin - 青霉素；盘尼西林
Penicillium - 青霉〔菌〕属
Penicillium crustaceum - 甲壳状青霉
p-coumaric acid - P—香豆酸
pectate - 凝胶质
pectinate - 栉齿状的
pedate - 鸟足状（复叶）；鸟足状分裂
peduncle - 总花梗；穗梗
peg - （子房延长而形成的）果柄
pelagic - 外洋性的
participate - 分配
particle - 微粒；粒子
partition - 深裂片，分割
partner - 配偶体
patella - 圆形子囊球
paternal - 父方的
pathogenesis - 病的演变
pathogenic bacteria - 病原细菌
pathogenic fungi - 病原菌
pathogeny - 病原学
paraxial - 沿生物体的主轴排列的
mutability - 可突变性；突变力
mutilate - 断残的
mutual aid - 互助
mutual assimilation - 相互同化作用
mutual exclusion - 互相排除
mutualism - 互依共存
mucin - 黏蛋白
Mucor - 毛霉属（毛霉菌科）；酵霉属
multifactorial - 多因子的
multilayer - 多层；多分子层
multilocular - 多室的
multivariate analysis - 多变值分析
murine - 鼠灰色
Murraya - 七里香属；月橘属（芸香科）
mother tree - 母树
motile - 运动性的；有自动力的
motility - 机动性
mounting medium - 封固剂
movement - 运动性的；有自动力的
mower - 刈草机
mowing - 刈草
Mucuna - 油麻藤属（豆科）
Mukdenia - 枫叶草属（虎耳草科）
mull - （有机物无机物混合而成的）腐植层
montane - 1.山岳的2.乔木线下的山地
mor - （不与无机物混淆的）致密有机层；酸性腐植土
Morchella - 网伞蕈属
Morinda - 羊角藤属（茜草科）
Morinda officinalis How - 巴戟天（本草经）
Moringa - 本辣木属；&#33838;菜树属（辣木科）
mos - 生态种群
mosaic - 嵌合体；镶嵌状
mosaic theory - 嵌合说；镶嵌说
monograph - （对于某一分类群或某一专题详细的）综合报告
monolayer - 单细胞层；单分子层
monoterpenes - 单松烯类
monotype - 单型；独一模式标本
monovalent - 单价
monsoon forest - 季节风雨林
Monascus - 红曲菌属
mongrel - 1.二不同系统交配后获得的个体2.杂种3.祖先不明〔的〕动物
monogamous - 1.一夫一妇的2.一雌一雄的3.有雌雄合同的花药的
monogamy - 一雌一雄配合
monophyletic - 单一系统发生的；单源的
mobile phase - 移动相
molal - 克分子量的；重量莫耳的
molar - 克分子的；莫耳的
molding - 培土；模制
molecular bond - 分子键
monad - 单价染色体
radioactive            - 放射性的
symmetry            - 对称
radial            - 放射状的
symmetrical            - 对称的
zymology            - 发酵学
ferox - 刺极多的；残暴的
ferrous - 二价铁的；低铁的；亚铁的
fertile - 可孕性的；有生殖能力；肥沃的
fertility - 可孕性；生殖力
fertility rate - 可孕率
fibrinolysis - 纤维蛋白分解
fascicle - 束集；聚伞（花序）；密伞花序
fast - 抗拒性；耐性
fatal - 致死
Fatsia - 八角金盘属（五加科）
feedback inhibition - 回馈抑制；返馈抑制
feedback mechanism - 回馈机制；返馈机制
female cone - 雌球花
fairy ring - 菌环；仙环
falcate - 镰刀状
female reproductive system - 雌〔性〕生殖系统
feminity - 雌性
fen - （美国的）卑湿性；沼泽地
fermentable - 可发酵的
family - (1)（分类学单位之一的）科(2)（生态学中的）族；家族
Haloxylon ammodendron - 梭梭
Shibataea - 倭竹属
Bambusa - 箣竹属
Sargentodoxaceae - 大血藤科
introgressive - 种间天然回交;
inulinase - 菊醣
inversion - 转化作用
inverted - 倒转的
ion density - 离子密度
ionization - 游离
Ipomoea - 番薯属;蕹菜属
interplanting - 间植
interpolated - 插入的;补入的
interrupted - 不连续的;中间受阻的
interspecies - 种间
intracellular - [细]胞内的
involution - 退缩;内旋
interaction - 交互作用;交感
interbreeding - 品种间杂种;变种繁殖
intercalated - 插在中间的
interior - 内部
interval - 休止时;中间休止时;间隔
intine - (花粉的)内壁
infrared spectrum - 红外线光谱　
inorganic phosphate - 无机磷酸盐
blood flow - 血流
blood glucose - 血糖
blood proteins - 血蛋白
blood serum - 血清
blood sugar - 血糖
blood velocity - 血液流速
blood volume - 血容积
body axis - 体主轴
cartilage - 软骨
cartilage cell - 软骨细胞
caudal fin - 尾鳍
caudal peduncle - 尾柄
cell membrane - 细胞膜
cement - 白垩
central nervous system - 中枢神经系统
axo-dendritic synapse - 树突神经元突触
axon - 轴突
body fluid - 体液
body shape - 体型
body temperature - 体温
bone cells - 骨细胞
bone formation - 骨形成
bone marrow - 骨髓
bone mineral content - 骨矿物质含量
bony plates - 骨板
Bowie - Bowie染色
brain cavities - 脑室
brain stem - 脑干
brain temperature - 脑温
backbone - 脊椎骨
balance of body - 体平衡
basal ganglia - 基神经节
belly - 腹部
bile - 胆汁
bilirubin - 胆红素
binocular vision - 双眼视觉
bleb - 泡
aortic arch - 大动脉弓(弧)
aortic root - 主动脉根
aponeurosis - 肌腱膜
apophysis - 脊椎突
aqueous humor - 水样液
arteries - 动脉
arterioles - 支动脉
astaxanthin - 虾红色素(鲑)
atrium - 心房
auditory nerve - 听觉神经
auricle - 心耳
autogamy - 目体受精
albinos - 白化体
fluorescein - 荧光素；萤红素
fluvial - 河生的；河流作用的
Fokienia - 福建柏属（柏科）
flavone - 黄~59_１~酮
flavonol - 黄~59_１~醇
fleshy - 柔软多汁的
flex - 弯曲
flocculation - 沉淀；胶体微粒集合成块而沉淀
flood - 泛滥平原
flooding - 浸水
floral formula - 花式
xiphoid            - 剑形的
vignin            - 豇豆球蛋白
reducer            - 还原者;还原剂
teratogenesis            - 畸形形成
rainfall            - 降雨量
Tremella            - 胶菌属(白木耳菌属)(担)
yeast            - 酵母﹝菌﹞
yeast            - 酵母菌
terrace            - 阶地;台地
conjugation            - 接合
Zygosaccharomyces            - 接合酵母菌属
switching            - 接通
Rotala            - 节节菜属（千屈菜科）
prolific            - 结果甚多的;有很多后裔的
union            - 结合
tuberculosis            - 结核症;结核病
realm            - 界
violin            - 菫菜素
fimbriae            - 菌毛
pili            - 菌毛
velar            - 菌膜
pseudotype            - 假模式标本
teratology            - 畸形学
pseudomembrane            - 假膜
polarization            - 极光
ultraplankton            - 极微浮游生物
torrential            - 急流生物的
Tribulus            - 蒺藜属(蒺藜科)
Piptanthus            - 黄花木属(豆科)
poliomyelitis            - 脊髓灰质炎
Thermopsis            - 黄华属(豆科)
candida            - 假丝酵母菌，念珠菌
yellowing            - 黄化
subculture            - 继代培养;更新培养
parasite            - 寄生菌
subiculum            - 寄主植物表面﹝上﹞﹝的﹞﹝很﹞密﹝的﹞菌丝体
stylus            - 尖锥瓣
subulate            - 尖锥状
Zamiaceae            - 坚果凤尾蕉科(裸)
type species - 模式种
typical - 典型的
tyrosine - 酪氨酸
uric acid - 尿酸
urinary bladder - 膀胱
urinary system - 泌尿系统
urine - 尿的
urotensin - 尾体素
vagina - 阴道
third eye - 第三眼
third ventricle - 第三心室
thorns - 棘刺
threshold - 阈值，临界
thrombosis - 血栓
thymocyte - 胸腺细胞
thyroglossal duct - 甲状腺舌管
thyroid gland - 甲状腺
thyroxine - 甲状腺素
tidal zone - 潮间带
tissue - 组织
tooth - 齿
tooth pulp - 齿髓
trabeculae - 横隔片，横条
trabecular bone - 横条骨
tractus olfactorius - 嗅囊束
synthetic - 综合的
syntype - 共型，全模标本
system - 系，系统
systematic - 系统的
systematics - 分类学
sythesis - 综合
tabular - 骨板
tactile - 触觉
tail - 尾
tail fin - 尾鳍
tail region - 尾部
taste bud - 味蕾
taste organs - 味器官
taxa - 分类单位(复数)
taxon - 分类单位(单数)
taxonomy - 分类学
teeth - 牙齿
tegument - 皮肤
telencephalon - 端脑
transversum - 横骨
triiodothyronine - 三碘甲状腺铵酸
submucosa - 黏膜下层
suborder - 亚目
subphylum - 亚门
subserosa - 浆膜下层
前闭壳肌  - anterior adductor muscle
前鞭毛体  - promastigote
前牙堤  - promargin
前盔  - frontal shield
前膜  - frontal membrane
前脑  - prosencephalon, forebrain
前神经孔  - anterior neuropore
前庭沟  - vestibular groove
前幽门孔  - prosopyle
原淋巴母细胞  - prolymphoblast
前直肌  - anterior rectus muscle
前中眼  - anterior median eye
漂鸟  - wandering bird
栖血的  - sanguicolous
鳍  - fin
鳍式  - fin formula
鳍条  - fin ray
气味腺  - scent gland, odoriferous gland
前背侧板  - prozonite
海底热泉  - hydrothermal vent
肝动脉  - hepatic artery
共栖结合  - commensal union
共生蓝藻  - syncyanosen
古生态学  - paleoecology
股骨  - femur
股直肌  - rectus femoris muscle
骨  - metatarsal bone
骨针  - sclere, spicule
鼓膜  - tympanic membrane
固定动作模式  - fixed action pattern (FAP)
肝区  - hepatic region
刚毛束  - setal fascicle
肛道  - proctodeum
直肠腺  - proctodeal gland
肛乳突  - anal papilla
稿模式  - chirotype
隔膜丝  - mesenterial filament
副肋粒  - paracostal granule
腹横肌  - transversus abdominis muscle
腹鳍牵缩肌  - retractor ventralis muscle
腹吸盘  - acetabulum, ventral sucker
根束  - rooting tuft
根纤维  - radicular fibre
跟座  - talonid
浮游动物  - zooplankton
辐射对称  - radial symmetry
辐射对称型  - radial symmetrical type
腐生营养现象  - saprophytism
父母印记  - parental imprinting
附齿  - supplementary tooth
microbiota - 一地区的微生物相；微生物区
microchemistry - 微量化学；显微化学
mesocarp - 中果皮（壁）
mesophanerophytes - 亚乔木植物
methyl - 甲基；甲烷基
mescaline - 戊种仙人掌~59_1~
mesh - 网孔
费洛蒙作用区  - active space
重复芽  - duplicate bud
子宫肌膜  - myometrium
自律性  - automaticity
自然发生  - abiogenesis, autogeny
天择  - natural selection
自体感染  - autoinfection
自营性生物  - autotroph
帚体  - phoront
昼夜节律  - day-night rhythm, circadian rhythm
皱襞  - plica
主观异名  - subjective synonym
主细胞  - chief cell
属  - genus
大脑导水管  - cerebral aqueduct
中央细胞  - central cell
中轴器  - axial organ
中轴索  - central chord
种间杂交  - species hybridization
种群  - species group
植   - zoophyte
指甲基质  - nail matrix
趾间腺  - interdigital gland
中肾  - mesonephros
黏液腺泡  - mucous acinus
粘液足  - mucous pad
粘着愈合  - adhesive fusion
掌  - palm [of hand]
蛰伏  - torpor
褶  - plica
针状骨针  - style
振鞭体  - vibraculum
脂肪水解  - lipolysis
执握器  - prehensile organ
直肠囊  - rectal sac
温度适应  - thermal adaptation
温跃层  - thermocline
纹状管  - striated duct
无髓神经纤维  - unmyelinated nerve fiber
围咽神经  - circumpharyngeal nerve
外套线  - pallial line
外旋神经  - abducent nerve
外肢  - exopod, exopodite
subulate            - 钻头形
rhodoxanthin            - 紫松果黄素
vertex            - 最高点;顶端
transmigration            - 转移;(离子)转移
state            - 状态
tracer            - 追踪物
quasi-static            - 准静态的
pigmentation            - 着色;色素产生
Porphyra            - 紫菜属(红)
syringin            - 紫丁香素
prematurity            - 早熟性
integration            - 整合
topiary            - 整形观赏树木
positive            - 正的
Kale - 羽衣甘蓝
agamospermous - 无融结籽的;无融合生殖植物
portal areas - 汇管区
Microcystis aeruginosa - 铜绿微囊藻
substrate concentration           - 受质浓度
ring cell           - 轮状细胞
urate cell           - 尿酸盐细胞
vascular bundle           - 维管束
lysogenic bacterium           - 溶原性细菌
spatial arrangement           - 空间排列
randomized block           - 逢机区集
A. caviae           - 豚鼠气单胞菌
systematic botany           - 植物分类学
structural botany           - 植物构造学
phylogenetic botany           - 植物系统学
microfold cell           - M细胞
Physical barrier           - 天然限制;天然障碍
stomatal aperture           - 气孔开口;孔口
plant breeding           - 植物育种
plague bacillus           - 鼠疫菌
reproductive behaviour           - 生殖行为
B. burgdorferi           - 伯氏疏螺旋体
inclusion body           - 包涵体
stearic acid           - 硬脂酸;十八酸
Streptomyces aureofaciens           - 金色链霉菌
L. acidophilus           - 嗜酸乳杆菌
titratable acid           - 可滴定酸
teichoic acid           - 磷壁酸
residual air           - 残留空气
Candida albicans           - 白假丝酵母菌
vitamin A           - 维生素甲二
vitamin A           - 维生素甲一
phosphatidic acid           - 磷脂酸
vinyl alcohol           - 乙烯醇
facultative anaerobe           - 兼性厌氧菌
nucleoside analogue           - 核苷类似物
神经索  - nerve cord
肾  - kidney
肾孔  - nephridiopore
渗透性营养  - osmotrophy
生产  - production
生长卵泡  - growing follicle
珊瑚冠类别  - anthocodial grade
上鼻甲  - superior concha
舌  - tongue, lingua
舌器  - hyoid apparatus
乳头突  - mamelon
闰盘  - intercalated disk
鳃瓣  - gill lamella
鳃间隔  - interbranchial septum
鳃甲  - branchiostegite
叁杆骨针  - triod
轭骨  - jugal bonemalar bone
裙礁  - fringing reefs
群体生态学  - synecology
群游  - swarm
人字骨  - chevron bone
下臼齿叁尖  - trigonid
乔丹定律  - Jordan's rule
桥虫  - bridge worm, Gephyra 
亲属选择  - kin selection
球棘  - sphaeridium
球内系膜细胞  - intraglomerular mesangial cell
球形群体  - spherical colony
绒羽  - down-feather
乳齿  - deciduous tooth
趋触性  - thigmotaxis
趋触性  - tihigmotaxis
趋化性  - chemotaxis, chemotaxy
趋温性  - thermotaxis
去分化  - dedifferentiation
去能  - decapacitation
theory of information          - 讯息说
mad cow disease          - 疯牛病
sexually transmitted disease          - 性传播疾病
relative water content          - 相对含水量
weapons - 武器，兵器
white blood cells - 白血球
white matter - 白质
yolk - 卵黄
Z-line - Z线
zoa - 动物之意
zona pellucida - 明带
zona reticularis - 网状带
zoo - 动物之意
zygote - 合子，受精卵
etiolation - 黄化
flavone - 黄酮
appressorium - 附着器
coverage - 盖度
glycyrrhizin - 甘草皂苷
perception - 感受
nasty - 感性
irritability - 感应性
higher plant - 高等植物
alpine flora - 高山植物区系
hypertonic solution - 高渗溶液
fruit - 果实
centrum - 果心
hypersensitivity - 过敏性
stone - 核
drupe - 核果
chalaza - 合点
chalazogamy - 合点受精
trace element - 痕量元素
constancy - 恒有度
palate - 喉凸
sclerenchyma - 厚壁组织
collenchyma - 厚角组织
chlamydospore - 厚垣孢子
rhizome - 根[状]茎
root/shoot ratio - 根冠比
root system - 根系
symbiont - 共生成分
paleobotany - 古植物学
nitrogen fixation - 固氮作用
holdfast - 固着器
limb - 冠檐
tracheid - 管胞
areal - 分布区
areal type - 分布区型
taxon - 分类单位
meristem - 分生组织
pycnidium - 分生孢子器
ramification - 分枝式
rima - 缝裂孔口
corona - 副花冠
stylus - 副体
subsidiary cell - 副卫细胞
ramulus - 副枝
imbricate - 覆瓦状的
winterness - 冬性
tundra - 冻原
hood - 兜状瓣
fragmentation - 断落
symmetry - 对称[性]
polyphenol - 多酚
polyad - 多合花粉
polyacetylene - 多炔
catechin - 儿茶素
dyad - 二合花粉
epiphyte - 附生植物
monarch - 单原型
monoterpene - 单萜
lodging - 倒伏
vessel - 导管
equivalent species - 等值种
local population - 地方种群
lichen - 地衣
diarch - 二原型
development phase - 发育期
pollination - 传粉
anticlinal wall - 垂周壁
anticlinal division - 垂周分裂
labium - 唇形盘缘
female cone - 雌球果
gynoecium - 雌蕊群
secondary metabolism - 次生代谢
secondary structure - 次生结构
mycobiont - 地衣共生菌
lichen flora - 地衣志
primary productivity - 第一性生产力
primary production - 第一性生产量
electron carrier - 电子载体
starch grain - 淀粉粒
sculpture - 雕饰
litter - 凋落物
apical meristem - 顶端分生组织
apical cell - 顶端细胞
apical initial - 顶端原始细胞
climax - 顶极[群落]
secondary xylem - 次生木质部
secondary phloem - 次生韧皮部
continental margin - 大陆边缘
continental shelf - 大陆架
metabolic regulation - 代谢调节
metabolite - 代谢物
basidiospore - 担孢子
monad - 单花粉
皮肤受器  - skin receptor
皮棘  - tegumental spine
皮鳃  - papula
macromolecules - 大分子
macrophage - 大噬菌体
lysogenic - 溶源的；诱导产生溶素的；诱导细胞溶解的；潜溶性的
lysozyme - 溶菌酶（细菌细胞壁黏质醣类分解酶）
saccule - 球囊
spherical colony - 球形群体
saccule - 球状囊
courtship - 求偶
stereotaxis - 趋实性
taxis - 趋性
sampling - 取样
dedifferentiation - 去分化
enucleation - 去核
migration - 迁飞
immigration - 迁入
migration - 迁徙
migrant - 迁徙动物
forearm - 前臂
foregut - 前肠
anterior chamber - 前房
frontal - 前面
canine tooth - 犬齿
ecotone - 群落交错区
community composition - 群落组成
colony - 群体
vestibule - 前庭器
方鳞  - square scale
方言  - dialect
飞航  - ballooning
非降解性  - nondegradation
肺  - lung
肺门  - hilum of lung
颚头  - gnathocephalon
耳舟  - scaphe
耳状骨  - auricle
二化  - divoltine
二头肌  - biceps muscle
翻颈部  - introvertere, introvert
生殖潜力  - biotic potential, reproductive potential
隐不动关节  - cryptosyzygy
营养个 、营养体  - gastrozooid
营养细胞  - trophoblast
硬茎  - stiff stem
蛹  - pupa
疣粒  - tubercle
游离端  - free end
有丝分裂  - mitosis
有头类  - craniate
原单核细胞  - promonocyte
痕迹化石  - trace fossil
疑性别的  - ambisexual
已引用  - loco laudato, loc. cit.
异型世代交替  - heterogeny
异质性  - heterogeneity
likelihood ratio - 近似比率
knot - 结；节
koji - 曲
light plant - 阳地植物
lightening - 电光照射；闪电
lignification - 木化；木质化
karyotype analysis - 核型分析
keratin - 动物性角质；角〔质〕蛋白；角素
key gene - 主要基因
kinase - 激酶；激活
kind - (纲目科似的天然群)
kindred - 谱系；血缘上有关系的人群
kinetin - 裂殖素
Kingdom - 界（动物界，植物界的界）
klinostat - 植物回转器
kaempferol - 番郁金黄素
kernel - （种子的）仁；禾榖类种实
kerosene - 石油烃类溶剂
ketohexose - 酮已糖
Juncaceae - 灯心草科；蔺科（单）
junction - 连接部；连接点
juxtapose - 相邻的
juxtaposition - 邻接位置
juba - （轴分枝的）圆锥花丛；簇生的榖针
isthmus - (接合藻类的)连接部
Ixonanthes - 粘木属(亚麻科)
J1 - 同系交配第一代
J2 - 近亲交配第二代
