生理学百科

Denaturation - 变性作用
Collagen - 胶原〔蛋白〕
active　transport  - 主动运输，主动转运
Myocardial Stunning - 心肌顿抑
second message - 第二信使
facilitated　diffusion  - 易化扩散，促进扩散
simple diffusion - 简单扩散
Fick's principle - 菲克原理
juxtapulmonary capillary - 肺毛细血管旁感受器
pulmonary stretch reflex - 肺牵张反射
Feng's effect - 冯氏效应
hepato-renal reflex - 肝-肾反射
Heidenhain's pouch - 海登海因小胃
tetrodotoxin, TTX - 河●毒素
transverse tubular system - 横管[系统]
constant fraction reabsorption - 恒定比率重吸收
redout - 红视
airway resistance - 呼吸道阻力
consensual reaction - 互感反应
basic electrical rhythm, BER - 基本电节律
mass peristalsis - 集团蠕动
squeeze - 挤压伤
kymograph - 记纹器
depressor nerve, aortic nerve - 降压神经
Coriolis acceleration - 科里奥利加速度
natriuretic hormone - 利尿钠激素
Marey's law - 马雷定律
stroke volume - 每搏输出量
vago-vagal reflex - 迷走-迷走反射
membrane digestion - 膜消化
cerebral ischemic response - 脑缺血反应
inward rectification - 内向整流
cortisol, hydrocortisone - 皮质醇
general physiology - 普通生理学
emergency reaction, fight-flight reaction - 应急反应
permissive action - 允许作用
episodic secretion - 阵发式分泌
central light loss, CLL - 中心视力丧失
peripheral light loss, PLL - 周边视力丧失
free water clearance - 自由水清除率
autonomic nervous system,vegetative nervous system - 自主神经系统
automatic thermoregulation - 自主性体温调节
final common path - 最后公路
sinus nerve - 窦神经,赫林神经
amine precursor uptake and decarboxylation system - APUD系统
factor I - [凝血]因子 I
factor V - [凝血]因子 V
factor Ⅶ - [凝血]因子 Ⅶ
factor Ⅷ - [凝血]因子 Ⅷ
factor ⅩⅢ - [凝血]因子 ⅩⅢ
factor Ⅺ - [凝血]因子 Ⅺ
factor Ⅱ - [凝血]因子Ⅱ
factor Ⅲ - [凝血]因子Ⅲ
factor Ⅸ - [凝血]因子Ⅸ
factor Ⅹ - [凝血]因子Ⅹ
factor Ⅻ - [凝血]因子Ⅻ
off-effect - “撤”效应
on-effect - “给”效应
Pavlov pouch - 巴甫洛夫小胃
leucocyte, white blood cell, WBC - 白细胞
Bainbridge reflex - 班布里奇反射
vesico-renal reflex - 膀胱-肾反射
Bezold-Jarisch reflex - 贝-亚反射
insensible perspiration - 不显汗
gonadotropin-releasing hormone, GnRH - 促性腺[激]素释放激素
gonadotropic hormone, gonadotropin, GTH - 促性腺激素
cholecalciferol - 胆钙化[甾]醇
Douglas bag - 道格拉斯袋
isohydric principle - 等氢离子原理
second messenger hypothesis - 第二信使学说
coexistence of transmitters - 递质共存
tuning curve - 调谐曲线
partial pressure of carbon dioxide, Pco2 - 二氧化碳分压
cascade theory, water-fall theory - 瀑布学说
generator potential - 启动电位
warming up - 热身运动
induced hibernation - 人工冬眠
human placental lactogen, HPL - 人胎盘催乳素
peristaltic rush - 蠕动冲
neurotensin, NT - 神经降压肽
reno-renal reflex - 肾-肾反射
adrenal insufficiency - 肾上腺皮质功能不全
somatomedin, SOM - 生长素介质
growth hormone release inhibiting hormone, GIH, somatostatin - 生长抑素
life-support system, LSS - 生命保障系统
bioelectrical preamplifier - 生物电前级放大器
biological amplification - 生物放大效应
surface-equivalent - 水面当量
underwater vision - 水下视觉
underwater hearing - 水下听觉
villikinin - 缩肠绒毛素
physical fitness - 体能
body temperature rhythm - 体温节律
systemic circulation, greater circulation - 体循环
universal stand - 通用支架
gastric phase - 胃期
sensible perspiration, sweating - 显汗
messenger - 信使
sex hormone binding globulin, SHBG - 性激素结合球蛋白
coitus, copulation - 性交
intrapleural pressure - 胸膜腔内压
hematocrit - 血细胞比容
ectopic hormone - 异位激素
hemolysis - 溶血
emulsification - 乳化作用
pacemaker - 起搏点
barotrauma - 气压性损伤
preload - 前负荷
tetanus - 强直收缩
bends - 屈肢症
disinhibition - 去抑制
warming up - 热身运动
heat exhaustion - 热衰竭
scanning electron microscope - 扫描电镜
color contrast - 色对比
color vision - 色觉
nociception - 伤害感受
nociceptor - 伤害性感受器
epidermal growth factor - 上皮生长因子
neural circuit - 神经回路
neuroendocrine - 神经内分泌
neuroendocrine cell - 神经内分泌细胞
innervation - 神经支配
hydrostatic pressure - 流体静力压
follicular development - 卵泡发育
pulse - 脉搏
pulse pressure - 脉搏压
pulse rate - 脉率
capillary pressure - 毛细血管血压
chymotrypsinogen - 糜蛋白酶原
patch clamp - 膜片箝
influx - 内向通量
energy exchange - 能量交换
energy balance - 能量平衡
energy expenditure - 能量消耗
vomiting reflex - 呕吐反射
collision - 碰撞
skinfold - 皮褶厚度
compression - 加压
compression chamber - 加压舱
hypoparathyroidism - 甲状旁腺功能减退
hyperparathyroidism - 甲状旁腺功能亢进
menopause - 绝经[期]
anticoagulation - 抗凝[作用]
spatial orientation - 空间定向
airsickness - 空晕病
presbyopia - 老视
steroid hormone - 类固醇激素
cold adaptation - 冷适应
eccentric exercise - 离心型运动
ion gradient - 离子梯度
brightness - 亮度
recruitment - 募集
sodium pump - 钠泵
internal environment - 内环境
endothelin - 内皮缩血管肽
erythropoiesis - 红细胞生成
afterload - 后负荷
respiratory membrane - 呼吸膜
breathing pattern - 呼吸型式
apnea - 呼吸暂停
luteal phase - 黄体期
reverberation - 回荡
rebound - 回跳
mechanism - 机制
squeeze - 挤压伤
indirect calorimetry - 间接测热法
rigor - 僵直
stage decompression - 阶段减压
firing - 发放
non-polarizable electrode - 乏极化电极
reflex - 反射
discharge - 放电
hepatic bile - 肝胆汁
receptor - 感受器
receptivity - 感受性
hypertension - 高血压
function - 功能
functional localization - 功能定位
glutamic acid - 谷氨酸
follicle stimulating hormone - 促卵泡激素
hypoxia - 低氧
electrical transmission - 电传递
action current - 动作电流
decapitation - 断头[术]
contrast sensitivity - 对比敏感性
light reflex - 对光反射
polygraph - 多道[生理]记录仪
nausea - 恶心
segmentation - 分节运动
compound action potential - 复合动作电位
on-effect - “给”效应
opioid - 阿片样物质
albumin - 白蛋白
cannula - 插管
long-term memory - 长时记忆
ultrafiltrate - 超滤液
overshoot - 超射
initial length - 初长
primary afferent - 初级传入
perspiration - 出汗
conduction - 传导
afferent nerve - 传入神经
gasping - 喘息
tape recorder - 磁带记录仪
bile pigments - 胆色素
factor Ⅷ - [凝血]因子 Ⅷ
differential blood count - 白细胞分类计数
intravesical pressure - 膀胱内压
Bezold-Jarisch reflex - 贝-亚反射
amenorrhea - 闭经
contraception - 避孕
ergometer - 测力计
Open Field       - 开场试验
Place Preference      - 学习记忆-位置偏爱
Pressure Sensor      - 超微压力传感器
Puller       - 拉制仪
species       - 物种
ABET       - 操作式行为测试
breed       - 品种
Calibration Equipment      - 显示校正系统
Data Acquisition      - 高速生理信号采集
experimental animal model     - 诱发性动物模型
Hole Board      - 孔板探究仪
isolator       - 隔离器
laboratory animal      - 实验室动物
Manipulator       - 显微操纵仪
mutant strain      - 突变系
NIBP       - 无创尾动脉血压测量
nude mouse      - 裸小鼠
strain       - 品系
subline       - 支系
Surgical Instruments      - 动物手术器械
Syringe Pump      - 微量注射泵
Tail Suspension      - 抗抑郁焦虑-悬尾试验
Ventilator       - 小动物呼吸机
Flow of energy - 能〔量〕流
Watch glass - 表面玻璃
Thyroid hormone - 促甲状腺激素
Nitrogen cycle - 氮循环
Leguminous plant - 豆科植物
Sulphur dioxide - 二氧化硫
Amino acid - 胺基酸﹔氨基酸
Detritus   - 碎屑﹔(2)腐质
Red blood cell - 红〔血〕细胞﹔红血球
Mesenteric artery - 肠系膜动脉
erythropoietin - 红细胞生成素，促红素
Water table - 地下水层﹔潜水面
Femoral artery - 股骨动脉
Substrate - (1)基质﹐(2)底物﹔
Cementum - 牙骨质
Community - 群落
Denture - 牙托
Diffusion - 扩化作用
Alcoholism   - 酗酒﹐醇中毒﹔酒精中毒
Extracellular fluid - 〔细〕胞外液
Rectus muscle - 〔眼〕直肌
excitement - 兴奋
resting state - 备用状态
Cerebrospinal fluid  - 脑髓液
Cocaine  - 古柯﹔可卡因
mean arterial pressure - 平均动脉压
autonomic　nervous system  - 植物性神经系统，自主神经系
Intertidal zone - 潮间带
Long bone - 长骨
peptide hormone - 肽类激素
tendon reflex - 腱反射
reuptake - 重摄取
axoplasmic transport - 轴浆运输
axial flow - 轴流
primary response - 主反应
autoregulation - 自身调节
summation - 总和
occlusion - 阻塞
organization - 组构
tissue fluid - 组织液
maximal oxygen uptake - 最大摄氧量
hiccup - 呃逆,打嗝
belching - 嗳气
intraocular pressure - 眼内压
oxygen content - 氧含量
oxygenation - 氧合
oxygen tension - 氧张力
oxygen toxicity - 氧中毒
insulinemia - 胰岛素血症
pancreatic lipase - 胰脂肪酶
facilitation - 易化
facilitated diffusion - 易化扩散
motion sickness - 运动病
augmentation - 增大
potentiation, enhancement - 增强
shivering thermogenesis - 战栗产热
emmetropia - 正视眼
rectal temperature - 直肠温度
direct calorimetry - 直接测热法
hemostasis - 止血
center - 中枢
fibrinolysis - 纤维蛋白溶解
digestive enzyme - 消化酶
cardiac contractility - 心肌收缩性
thymosin - 胸腺[激]素
blood circulation - 血[液]循环
blood viscosity - 血[液]粘度
blood-testis barrier - 血－睾屏障
hematocrit - 血细胞比容
platelet aggregation - 血小板聚集
depression - 压抑
dominant hemisphere - 优势半球
aerobic metabolism - 有氧代谢
reproductive life - 育龄
ossicular chain - 听骨链
microgravity - 微重力
gut hormone - 胃肠激素
gastroenterology - 胃肠学
gastric juice - 胃液
homeostasis - 稳态
inspiration - 吸气
cytoprotection - 细胞保护作用
hypothalamic-pituitary-adrenal axis - 下丘脑－垂体－肾上腺轴
cardiac reserve - 心力贮备
cardiac output - 心输出量
cardiac index - 心指数
messenger - 信使
excitability - 兴奋性
performance - 行为表现
visual cortex - 视皮层
visual threshold - 视阈
contractility - 收缩性
relaxation - 舒张
diastasis - 舒张末期
end-diastolic pressure - 舒张期末压
shortening period - 缩短期
specific projection system - 特异投射系统
shell temperature - 体表温度
core temperature - 体核温度
ventilation - 通气
permeability - 通透性
pain - 痛
turbulent flow - 湍流
saliva - 唾液
efflux - 外向通量
micromanipulator - 微操作器
adrenal insufficiency - 肾上腺皮质功能不全
glomerular filtration - 肾小球滤过
physiology - 生理学
fertility - 生育力
reproduction - 生殖
blood loss - 失血
adaptive behavior - 适应性行为
steady flow  -  稳定流动（定常流动）
subunit  -  亚单位，亚基
surface tension  -  表面张力
tertiary structure  -  三级结构
electromagnetic induction  -  电磁感应
electromotive force  - 
electrophoretic mobility  -  电泳率
emission spectra  -  发射光谱
energy density  -  能量密度
energy level  -  能级
excited state  -  激发态
facilitated diffusion  -  易化扩散
fluid  -  流体，液体
fluorescence  -  荧光
fluorescence intensity  -  荧光强度
freedom  -  自由度
membrane fluidity  -  膜流动性
momentum  -  动量
natural frequency  -  固有频率（本征频率）
natural light  -  自然光 
numerical aperture  -  孔径数
optical path  -  光程
optical thickness  -  光学厚度
order parameter  -  序参数
osmotic pressure  -  渗透压
passive transport  -  被动运输，被动转运
patch clamp  -  膜片钳
period  -  周期
permeability  -  磁导率，通透性
phase  -  相位
phase transition  -  相变
precession  -  旋进（进动），向前运动
primary structure  -  一级结构
quantization  -  量子化
quantum  -  量子
quantum mechanics  -  量子力学
quaternary structure  -  四级结构
quenching  -  猝灭
resistivity  -  电阻率
resolving power  -  分辨力
secondary structure  -  二级结构
sound wave  -  声波
absorption  -  吸收,吸收作用
absorption coefficient  -  吸收系数
absorption spectrum  -  吸收光谱
additional pressure  -  附加压强
aggregation  -  聚集，聚集态
amplitude  -  振幅
analyzer  -  检偏器
angular momentum  -  角动量
Birefringence  -  双折射
calcium channel  -  钙通道
capillarity  -  毛细现象
carrier  -  携带者，载体，载流子，带虫者
cell adhesion  -  细胞粘合
deformation  -  畸形
dimension  -  量纲
dipole  -  偶极子
elasticity  -  弹性
electric current  -  电流
electric current density  -  电流密度
electric field  -  电场
grating  -  光栅
ground state  -  基态
heat radiation  -  热辐射
ideal gas  -  理想气体
infrared spectroscopy  -  红外光谱
internal energy  -  内能
kinetic energy  -  动能
laser  -  激光
lipid bilayer  -  脂双层
lipid peroxidation  -  脂质过氧化
magnetic field  -  磁场
Enamel - 牙釉质﹔珐琅质
Eyepiece - 〔接〕目镜
Leaching - 淋溶
Integration - 整合作用
Diarrhoea - 腹泻
Progesterone - 孕酮
Hearing - 听〔觉〕
Mongoloid - 黄种﹔蒙古人种
Slide - 玻片
Strain - (1)菌株﹐(2)品系
Locus - 位点
Lysin - 〔细胞〕溶素
Dieting - 节食
Hematocrit - 血细胞比容﹔血细胞容量计
Homozygous - 纯合的
Parathyroid - 甲状旁腺﹔副甲状腺
Phylum - 门
Polynucleotide - 多核酸
Skull - 颅骨﹔头颅
Paracetamol - 朴热息痛
Haemolysis - 溶血作用
Protease - 蛋白
Transcription - 转录作用
Lipase - 脂〔肪〕
Pipette - 移液管
Lemur - 狐猴
Decomposition - 分解作用
Incisor - 门齿﹔切齿
Oedema - 水肿
Permeability - 可透性
Pregnancy - 妊娠﹔怀孕
Gonadotrophin - 促性腺激素
Mushroom - 菇类
Predator - 捕食者
Submucosa - 黏膜下层
Nematode - 虫
diffusion - 扩散，弥散
Blood alcohol concentration (BAC) - 血酒精浓度
Acromegaly - 肢端巨大症
Hermaphrodite - 雌雄同体
Monocyte - 单核白〔血〕细胞﹔单核白血球
Phenacetin - 非那西汀
Claw - 爪
Degradation - 降解作用
Primate - 灵长类
Maltose - 麦芽糖
Streak - 划
Pivot - 枢轴关节
Prey - 猎物﹔被捕食者
Termite - 白蚁
Millipede - 马陆﹔千足虫
Yolk - 卵黄
Tuberculosis - 结核〔病〕
Trait - 特征
Limb bone - 肢骨
Antibiotic - 抗生素﹔抗菌素
Beaker - 烧杯
Effector - 反应器
Erector - 竖立肌
Condyle - 骨突
Endospore - 内孢子
Herb - 草本植物
Spinal column - 柱
Patella - 膝盖骨﹔髌
Gynecology - 妇科
Sporangium - 孢子囊
Streptomycin - 链霉(霉)菌属
Silicosis - 硅肺﹔石末沉着病
Ultrafiltration - 超滤作用
Booster - 加强剂
Carbohydrase - 碳水化合物
Circulation - 循环作用
Dropper - 滴管
Follicle - 卵泡
Superior vena cava - 上腔大静脉
Bile salt - 胆盐
Ear drum - 耳膜
surface activation - 表面激活
tonic activity - 紧张性活动
catabolism - 分解代谢，异化作用
alveolar　dead space  - 肺泡死腔，肺泡无效腔
plateau - 平台期
Basilar membrane - 基膜
Alcoholic fermentation - 酒精发酵
Ringer's solution - 林格氏溶液
Epidermal cell - 表皮细胞
baroreceptor　reflex  - 压力感受性反射
Arterial pressure - 动脉血压
albumin - 白蛋白，清蛋白
Granular layer - 〔颗〕粒层
Synovial fluid - 滑液
Gaseous exchange - 气体交换
Iliac artery - 髂骨动物﹔肠骨动脉
Parental care - 亲代养育
Soft palate - 软
Haldane　effect  - 何尔登效应
fibrinolysis - 纤溶
Hydrogen sulphide - 硫化氢
Gonad - 生殖腺﹔性腺
Irritability - 感应性
Palm - 手掌
Scale - 鳞〔片〕
Savanna - 〔热带〕稀树干草原
Quarantine - 检疫﹔隔离
Socket - 槽
Testosterone - 睪〔固〕酮
Detergent - 清洁剂
Fermentation - 发酵作用
Mechanism - 机制﹔机理
Lancet - 刺血针
Spirillum - 螺〔旋状〕菌
Casualty - 急症室
Cement - 牙骨质﹔白垩质
Condenser - 聚光器
Cyst - 胞囊﹔囊
Afterbirth - 胎盘胎膜
Digestion - 消化作用
Lysozyme - 溶菌
Decay - 腐败
Transmitter - 传导物质﹔传递介质
Prolactin - 促乳素
Sedimentation - 沉降
Vacuole - 液泡
Host - 寄主
Liver - 肝〔脏〕
Mucus - 黏液
Squash - 压片
Symbiont - 共生物
Tartar - 牙垢﹔牙石
Synthesis - 合成作用
Oven - 烘箱
Pesticide - 杀虫剂
Posture - 姿态﹔体位
Zooplankton - 浮游动物
Nondegradable - 非降解性
Putrefaction - 腐败作用
Reabsorption - 重吸收作用
Reflex - 反射〔作用〕
Sneezing - 喷嚏
Sulphonamide - 磺胺
Sole - 足掌
Spider - 蜘蛛
Vertebrate - 椎动物
Shrub - 灌木
Testis - 睪丸
Ventricular - systole
Vegetation - 植被
Sludge - 污(淤)泥
Spine - 柱
Rennin - 凝乳
Rhizopus - 根霉
Stopper - 塞
Secretin - 分泌素﹔肠促胰液素
Reptile - 爬行动物
Vial - 指管
Trauma - 创伤﹔外伤
Tundra - 冻原
Lesion - 损害﹔病损
Mitochondrion - 粒体
Decongestant - 减充血剂
Solvent - 溶剂
Sterilization - (1)灭菌﹔消毒﹐(2)绝育
Deoxyribose - 脱氧核糖
Dissection - 解剖
Glycerol - 甘油糖原
Mucosa - 黏膜
Predation - 捕食
Filtration - 过滤法
Ribose - 核糖
Saline - 盐水
Taxonomy - 分类〔学〕
Leucocyte - 白细胞﹔白血球
Phlegm - 痰
Prenatal - 出生前的
Shrink - 萎缩
Sterile - (1)无菌﹔(2)不育
Narcissism - 自恋
Precaution - 预防措施
Hydrochloric acid - 盐酸
Alveolus - 肺泡
Auricle - 心耳
Bolus - 食团
Stethoscope - 
Mutualism - 互利共生
Mould - 霉〔菌〕﹔霉〔菌〕
Process - 突〔起〕
Producer - 生产者
Wildlife - 野生生物
Opiate - 鸦片制剂
Non-disjunction - 不分离现象
Prothrombin - 凝血原
Spreader - 摊开器
Starfish - 海星
Parturition - 分娩
Pepsin - 胃蛋白
Condom - 避孕套
Convulsion - 抽搐
Nosepiece - 物镜转换器
Nucleus - 〔细胞〕核
Phenylketonuria - 苯(丙)酮尿症
Haemophilia - 血友病
Heart - 心〔脏〕
Pickling - 腌泡
Tumour - 肿瘤
Lice - 虱
Order - 目
Section - 切片
Crustacean - 甲壳类动物
Ilium - 髂骨﹔肠骨
Pest - 害虫
Coping - 顺应
Chronic - 慢性
Neomycin - 新霉(霉)素
Nutrient - 营养素﹔养份
Organism - 生物﹔有机体
Lumen - 腔
Rashes - 疹
Sacrum - 荐骨
Spinal nerve - 髓神经
Nitrite bacteria - 亚硝酸细菌
Glans penis - 阴茎头
Anopheles - 按蚊属
Arteriole - 小动脉
Biochemical - 生化的
Colonization - 集群现像
Dentition - 牙列
Effluent - 废水
Gibbon - 长臂猿
Class - 网
Hydrocarbon - 碳氢化合物
Hysteria - 病﹔歇斯底里
Kwashiorkor - 加西卡﹔蛋白缺乏病
Population - (1)人口﹐(2)种群
Hair - 毛〔发〕
Salmonella - 沙门氏菌属
Flocculation - 絮凝〔作用〕﹔絮状沉淀法
Lactase - 乳糖
Heterotroph - 异养生物
Humerus - 肱骨﹔上膊骨
Oligosaccharide - 低聚醣
Stress - 紧张状态﹔精神压力
Griseofulvin  - 灰黄霉(霉)素
Wrist bone - 腕骨
Cell wall - 细胞璧
Digestive system - 消化液
Messenger RNA - 信使核糖核酸
Primitive reflex - 原始反射
Maternal care - 孕妇保健
Fat soluble - 脂溶性的
Actinomycete - 放菌
Cyclop - 剑水蚤
Lung - 肺〔脏〕
Lymph gland - 淋巴腺
Quinine  - 奎宁﹔金纳碱
Clostridium tetani - 破伤风梭状芽胞杆菌
Living organism - 生命有机体
Trophic level - 食性层次
Acid rain - 酸雨
Auditory canal - 听道
Hyaline cartilage - 透明软骨
Heart muscle - 心〔脏〕肌
Spinal canal - 椎管
Alga - 藻
Asbestosis - 石棉沉着病
Cirrhosis - 肝硬化
Colony - (1)集群﹔群体﹐(2)菌落
Discharge - 流出
Antihistamine - 抗组胺药
Fungicide - 杀真菌剂
Syringe - 针筒
Dinoflagellate - 双鞭藻
Lactation - 泌乳作用
Opsonin - 调理素
Optimum - Ph
Forceps - 镊子
Function - 功能﹔功用
Sprinkler - 洒水装置
Translation - 转译作用
Subcutaneous fat - 皮下脂肪
Degenerative disease - 退化病
Round window - 正圆窗
Character - (1)性状﹐(2)特征
Deforestation - 滥伐〔林木〕
Aedes - 伊蚊属
Boil - 疖
Label - 标记﹔标签
Muscle tone - 肌紧张
Water purification - 净化作用
Venous system - 静脉系统
Penicillium  - 青霉(霉)菌
Energy value - 能量值
Oblique muscle - 斜肌
Blood clot - 血凝块
Organic matter - 有机质
Acetylcholine - 乙醯胆碱
Antiperspirant - 止汗药
Alcoholic - 酗酒者
Key - 检索表
Midlife - 中年期
Calculus - 齿石
Labour - 分娩
Librium - 利眠宁
Sight - 视觉
Neurone - 神经元
Pancreas - 胰〔脏〕
Thrombin - 凝血
Kidney - 肾〔脏〕
Periwinkle - 滨螺
Segment - 体节﹔环节
Rodents - 啮齿类
Sense organ - 感觉器官
Mercury poisoning - 汞中毒
cardiac　reserve  - 心力储备
Acquired immune deficiency syndrome　(AIDS) - 后天免疫力缺乏症(艾滋病)
Alcohol dependence - 酒
Air pollution - 空气染污
Monosodium glutamate - 麦夫胺酸钠﹔谷氨酸钠
Clotting factor - 凝血因子
Upper arm - 上臂
Dietary fibre - 食用纤维
Water pollution - 水污染
Knee cap - 膝盖
Water flea - 水蚤
Calcium carbonate - 碳酸
Smog  - 毒雾﹔雾
Chloramphenicol - 氯霉(霉)素
Dermatitis - 皮〔肤〕炎
Diatom - 硅藻
Egestion - 排遗作用
Glenoid - 肩臼
Fracture - 脆裂
Galactose - 半乳糖
Hypnotic - 催眠药
Impulse - 脉冲
Generation - 〔世〕代
Mussel - 贻贝
Orbit - 眶﹔眼窝
Penicillin - 青霉(霉)素
Lichen - 地衣
Objective - 〔接〕物镜
Pelvis - (1)骨盆﹐(2)肾盂
Starch grain - 淀粉粒
Tropical rain forest - 热带雨林
Mayfly nymph - 蜉蝣若虫
Hydrogen peroxide - 过氧化氢
Bubonic plague - 黑死病
Base sequence - 碱基顺序
Mantoux test - 结核菌素皮内试验
Zona pellucida - 明带
Population explosion - 人口爆炸
Salmonella typhi - 伤寒杆菌
Community health - 社会健康
Ecological succession - 生态演替
Vas deferens - 输精管
Amylase - 淀粉
Depressant - 抑制药﹔镇静剂
Family - 科
Female - 女性
Vertical section - 纵切面
Backbone - 柱
Conservation - 保护﹔保持
Dilute - 稀释
Epididymis - 附睪
Erosion - 侵蚀
Anaesthesia - 麻醉法
Competiton - 竞争
Grid - 格子
Meninx - 脑膜
Contraceptive pill - 避孕丸
Transverse process - 横突
Pressure cooker - 加压蒸煮器﹔高压锅
Country park - 郊野公园
Muscle fibre - 肌纤维
Flaming  - 灭菌火
Pancreatic duct - 胰管
Hard palate - 硬
Bactericide - 杀〔细〕菌剂
Biocide - 杀生物剂
Biodegradable - 生物可降解的
Exponential growth - 指数增长
Anti-depressant - 抗抑郁药
Differentiation - 分化作用
Cork - 木栓
Histamine - 组〔织〕胺
Inclusion - 内含体
Odontoid process - 齿状突
Cerebral cortex - 大脑皮层
Agglutination - 凝集作用
Analgesic - 镇痛剂
Asepsis - 无菌法
Incubator - 恒温箱
Influenza - 流行性感冒
Bristle - 刚毛
Secretion - (1)分泌作用﹐(2)分泌物
pulmonary ventilation - 肺通气
Sea anemone - 海葵
Sodium alginate - 褐藻酸钠
Reducing sugar - 还原糖
Shoulder girdle - 肩带
blood　flow  - 血流量
Hepatic portal vein - 肝门静脉
Fossil fuel - 化石燃料
Balanced diet - 均衡膳食
Caesarian section - 剖腹取子术
Upper jaw - 上颚
Stereoscopic vision - 实体视觉
Digestive enzyme - 消化
Plasma protein - 血浆蛋白
Motor neurone - 运动神经元
Amnesia - 记忆缺失﹔遗忘〔症〕
Anaerobe - 厌氧生物
Body - 躯体
Carnivore - 食肉生物
Albumen - 蛋白
Emulsifier - 乳化剂
Erythrocyte - 
Fertilizer - 肥料
Medium   - 培养基﹐(2)介质
Ph paper - Ph试纸
endocytosis - 胞吞,入胞,内吞
Reducing agent - 还原剂
Birth control - 控制生育﹔节育
Proteolytic enzyme - 蛋白〔水解〕
membrane potential - 跨膜电位，膜电位
anticoagulation - 抗凝
Collagen fibre - 胶原纤维
Agar plate - 琼脂平面
Calf muscle - 小腿肌肉
Absorption - 吸收作用
Anaesthetic - 麻醉剂
Cervix - (1)颈﹐(2)子宫颈
Denitrification - 反硝化作用﹔脱氮作用
Albinism - 白化
Flea - 蚤
Habituation - 习惯形成﹔成瘾
gastric　acid  - 胃酸
Diaphragm   - 横膈膜﹐(2)光栏
plasminogen - 纤溶酶原,纤维蛋白溶酶原
Community health service - 社康服务
Spatula  - 刮﹔药匙
Endangered species - 濒危物种
renin - 肾素
Ear fluid - 耳液
Pulmonary vein - 肺静脉
Oxygenated blood - 含氧血
heart　rate  - 心率
Mental illness - 精神病
Entamoeba histolytica - 痢疾变形虫
Pituitary gland - 脑垂腺
Nerve impulse - 神经脉冲
Lactobacillus acidophilus - 嗜乳酸杆菌
Copper sulphate - 硫酸铜
Prostate gland - 前列腺﹔摄护腺
Papillary muscle - 乳突肌
Homologous chromosomes - 同源染色体
Soil structure - 土壤结构
Gastrointestinal tract - 胃肠管
Aflatoxin - 黄曲霉素
Aquaculture - 水产养殖
Choroid - 脉胳膜
Condensation - 缩合反应
Tocopherol (vitamin E) - 生育
Homeostasis - 内环境稳定，稳态
Genital herpes  - 生殖器疹
Metabolic disorder - 代谢失调
Red blood corpuscle - 红血球﹔红〔血〕细胞
Propylene glycol - 丙二醇
Sperm cell - 精细胞
Sodium hydroxide - 氢氧化钠
Enzyme  - 素
Seminal vesicle - 贮精囊
Autoclave - 高压灭菌器；消毒蒸锅
Bird - 鸟
Canopy - (1)树冠﹐(2)冠层
Chlorination - 加氯消毒法
Deamination - 脱胺作用﹔脱氨基作用
Extract - 抽出液
permeability - 磁导率，通透性
Drug dependence - 药瘾
Central dogma - 中心法则
Drug - 药〔物〕
Aggression - 攻击性行为
Bactericidal - 杀菌的
Broth - 液体培养基
Caramel - 焦糖
Cortex - 皮层﹔皮质
Girdle - 带
incompatibility - 血型不和
Trichomonas vaginalis - 阴道毛滴虫
Organic substance - 有机物
rhesus monkey - 恒河猴,猕猴
audition - 听力
angiotensin - 血管紧张素
in　vivo  - 在体(实验)，体内
Mortar and pestle - 研钵及研杵
Amino group - 胺基﹔氨基
inactivation  - 灭活(病毒)，失活
adrenergic - 肾上腺能的
enteric nervous system - 肠道神经系统
Node of Ranvier - 郎〔飞〕氏结
Background radiation - 本底辐射
pacemaker current - 起搏电流
Cannabis sativa - 大麻
Peptide bond - 键
Rib cage - 肋骨篮
Cotton wool - 棉絮
Nervous tissue - 神经弓
Lower jaw - 下颚
Narcotic - 痲醉剂
Presbyopia - 老视〔眼〕
Myelin - 髓磷酯﹔髓鞘质
Sensitivity - 感应性﹔敏感性
Vulva - (1)阴门﹐(2)外阴
Glacial acetic acid - 无水醋酸
Neisseria gonorrhoeae - 淋球菌
Living system - 生命系统
Fertilized egg - 受精卵
Water potential - 水潜能﹔水势
Epidemic disease - 流行病
Portal circulation - 门脉循环
Common cold - 伤风
Food additive - 食物附加剂
Carbonic anhydrase - 碳酸
caloric　value  - 卡价（或热价）
spike - 刺突，锋电位
Guanine - 鸟〔粪〕嘌呤
Leech - 蚂蟥
Manometer - 液体压强计
Allergy - 过敏反应
Slug - 蛞蝓
Pericardium - 围心膜﹔心包
Irritant - 刺激物
Lymphocyte - 淋巴细胞﹔淋巴球
Obligate - 专性
Heterozygous - 杂合的
Stain - (1)染色﹐(2)染色剂
Ventricle - (1)室﹐(2)心室
Scalpel - 解剖刀
Genus - 属
Aerobe - 需氧生物
Asthma - 气喘﹔哮喘
Gum - 齿龈
Culex - 库蚊属
Alcohol - 醇﹔酒精
Aorta - 大动脉
Larva - 幼虫
Rhodopsin - 视紫〔红质〕
Waste - 废物
prothrombin - 凝血酶原
gastrin - 胃泌素
Portal system - 门脉系统
Medical ward - 内科病房
Blood clotting - 凝血作用
Beef extract - 牛肉汁
Eustachian tube - 欧氏管﹔耳咽管
Chromosome number - 染色体数
Gestation period - 妊娠期
Neural arch - 神经管
in　vitro  - 体外(实验)，离体
