眼科学百科

intermediate uveitis - 中间葡萄膜炎
central vision - 中心视力
central serous chorioretinopathy - 中心性浆液性脉络膜视网膜病变
foveal reflex - 中央凹反射
endposition nystagmus - 终位性眼球震颤
cylindrical lens, cyl - 柱镜片
autofluorescence - 自身荧光
total hypermetropia, Ht - 总远视
serpiginous corneal ulcer, Saemisch corneal ulcer - 匍行性角膜溃疡
chalazion - 睑板腺囊肿
pinguecula - 睑裂斑
hordeolum - 睑腺炎
keratometer - 角膜曲率计
corneal tattooing - 角膜染色术
ciliary block glaucoma - 睫状环阻塞性青光眼
cyclodialysis - 睫状体分离术
cyclocryosurgery - 睫状体冷凝术
luxation of lens - 晶状体脱位
lensinduced uveitis - 晶状体性葡萄膜炎
fundus albipunctatus cum nyctalopia congenita - 静止型白点状眼底
absolute glaucoma - 绝对期青光眼
evisceration of orbit, exenteration of orbit - 眶内容摘除术
senile cataract - 老年性白内障
senile macular degeneration, SMD - 老年性黄斑变性
dacryocystorhinostomy - 泪囊鼻腔吻合术
dis[] of lacrimal gland - 泪腺脱垂
prismatic lens - 棱镜片
slitlamp microscope - 裂隙灯显微镜
vitelliform macular degeneration, best disease - 卵黄状黄斑变性
subchoroidal expulsive hemorrhage - 脉络膜下爆发性出血
confrontation method - 面对面视野检查[法]
endocrine exophthalmos - 内分泌性眼球突出
examination of internal eye - 内眼检查[法]
vaccinial keratitis - 牛痘性角膜炎
IrvineGass syndrome - 欧文-加斯综合征
phlyctenular pannus - 泡性血管翳
corticosteroid glaucoma - 皮质类固醇性青光眼
cortical cataract - 皮质性白内障
uveitis - 葡萄膜炎
anterior ischemic optic neuropathy, AION - 前部缺血性视神经病变
hyphema - 前房积血
hyperfluorescence - 强荧光
glaucomatocyclitic syndrome, PosnerSchlossmann syndrome - 青光眼睫状体炎综合征
spherical lens, Sph - 球镜片
counting fingers, CF - 数指
binocular indirect ophthalmoscope - 双目间接检眼镜
double flash electroretinogram - 双闪光视网膜电图
distichiasis - 双行睫
diabetic retinopathy - 糖尿病[性]视网膜病变
interpupillary distance - 瞳孔距离
pseudomonas aeruginosa corneal ulcer - 铜绿假单胞菌性角膜溃疡
transmitted fluorescence - 透见荧光
transillumination - 透照法
convex lens - 凸球镜片
examination of external eye - 外眼检查[法]
simulated blindness - 伪盲
photophobia - 畏光
congenital retinal fold - 先天性视网膜皱襞
strabismus - 斜视
neovascular glaucoma - 新生血管性青光眼
form deprivation amblyopia - 形觉剥夺性弱视
ophthalmoplasty - 眼成形术
cholesterolosis bulbi - 眼胆固醇沉着症
ophthalmoxerosis, xerophthalmia - 眼干燥症
evisceration of eyeball, exenteration of eyeball - 眼内容摘除术
endophthalmitis - 眼内炎
intraocular foreign body - 眼内异物
localization of intraocular foreign body - 眼内异物定位[法]
extraction of intraocular foreign body - 眼内异物摘出术
perforating injury of eyeball - 眼球穿孔伤
ocular tenonitis - 眼球筋膜炎
endophthalmos - 眼球内陷
enucleation of eyeball - 眼球摘除术
nevus fuscoceruleus ophthalmomaxillaris - 眼颧部褐蓝痣
ocular siderosis - 眼铁质沉着症
ophthalmic migraine - 眼性偏头痛
intraocular tension, intraocular pressure, IOP - 眼压
hypophasis - 眼睑闭合不全
herpes febrilis palpebrae - 眼睑热病性疱疹
epiphora - 溢泪
phoria - 隐斜
fundus fluorescein angiography - 荧光素眼底血管造影[术]
blocked fluorescence - 荧光遮蔽
aniseikonia - 影像不等
sclerocornea - 硬化性角膜
crowding phenomenon - 拥挤现象
persistent hyaloid artery - 永存玻璃体动脉
persistent pupillary membrane - 永存瞳孔膜
persistent hyperplasia of primary vitreous, PHPV - 永存原始玻璃体增生症
primary openangle glaucoma - 原发性开角型青光眼
primary detachment of retina - 原发性视网膜脱离
retinopathy of prematurity syndrome - 早产儿视网膜病变综合征
proliferative diabetic retinopathy, PDR - 增生型糖尿病[性]视网膜病变
proliferative vitreoretinopathy, PVR - 增生性玻璃体视网膜病变
pinhole disk - 针孔片
normal tension glaucoma - 正常眼压性青光眼
digital tonometry - 指触眼压测量[法]
exofoliation syndrome - 剥脱综合征
degenerative myopia - 变性近视
epikeratophakia - 表层角膜镜片术
vitreous hemorrhage - 玻璃体积血
vitrectomy - 玻璃体切割术
rodent corneal ulcer, Mooren ulcer - 蚕食性角膜溃疡
delayed filling - 迟缓充盈
vernal conjunctivitis - 春季结膜炎
macrocornea - 大角膜
bullous keratopathy - 大泡性角膜病变
macrophthalmia - 大眼球
streak retinoscope - 带状光检影镜
herpes simplex keratitis, HSK - 单纯疱疹性角膜炎
hypocalcemic cataract - 低血钙性白内障
amplitude of accommodation - 调节幅度
arteriosclerotic retinopathy - 动脉硬化性视网膜病变
muscae volitantes - 飞蚊症
sutural cataract - 缝性白内障
radiational cataract - 辐射性白内障
Fuchs endothelial dystrophy of cornea - 富克斯角膜内皮营养不良
plateau iris - 高褶型虹膜
Gunn crossing sign - 耿氏交叉征
donor's cornea - 供体角膜
scleral ectasia - 巩膜膨隆
concomitant esotropia - 共同性内斜
concomitant exotropia - 共同性外斜
concomitant strabismus - 共同性斜视
light projection - 光定位
panretinal photocoagulation - 广泛视网膜光凝术
Hutchinson pupil - 哈钦森瞳孔
iris repositor - 虹膜复位器
rubeosis of iris - 虹膜红变
iridencleisis - 虹膜嵌顿术
heterochromia iridium - 虹膜异色症
iridodonesis - 虹膜震颤
thick pannus - 厚血管翳
acquired blindness - 后天性盲
coronary cataract - 花冠状白内障
intrastroma photorefractive keratectomy, IPK - 基质内光性屈光性角膜切除术
interstitial keratitis - 基质性角膜炎
exciting eye - 激发眼
convergence, Con - 集合
acute multifocal ischemic choroidopathy, AMIC - 急性多发性缺血性脉络膜病变
pseudomembranous conjunctivitis - 假膜性结膜炎
pseudomyopia - 假性近视
intercalary scleral staphyloma - 间插性巩膜葡萄肿
ophthalmoscope, Oph - 检眼镜
skiascopy, retinoscopy - 检影[法]
skiascope, retinoscope - 检影镜
crossed cylinder lens - 交叉柱镜
sympathizing eye - 交感眼
corneal nebula - 角膜薄翳
bandshaped degeneration of cornea - 角膜带状变性
keratic precipitates, KP - 角膜后沉着物
keratomileusis - 角膜磨削术
perinuclear cataract - 绕核性白内障
artificial pupil - 人工瞳孔
retinopathy of pregnancy and hypertension syndrome - 妊娠高血压综合征［性］视网膜病变
hypofluorescence - 弱荧光
photopsia - 闪光感
ptosis - 上睑下垂
depth perception - 深度觉
baring of physiological blind spot - 生理盲点外露
papillopathy - 视[神经]盘病变
papilloretinopathy - 视[神经]盘视网膜病变
optic disc vasculitis - 视[神经]盘血管炎
disc diameter, DD - 视[神经]盘直径
optokinetic nystagmus, OKN - 视动性眼球震颤
visual evoked potential, VEP - 视觉诱发电位
asthenopia, Asth - 视疲劳
retinal hole - 视网膜裂孔
retinotomy - 视网膜切开术
detachment of retina - 视网膜脱离
ophthalmodynamometry, ODM - 视网膜血压测量[法]
ophthalmodynamometer - 视网膜血压计
nevoid pigmentation of retina - 视网膜痣样色素沉着
macropsia - 视物显大症
polyopsia - 视物显多症
Adie pupil - 埃迪瞳孔
concave lens - 凹球镜片
albescent punctate degeneration of retina - 白点状视网膜变性
central vision - 中心视力
central serous chorioretinopathy - 中心性浆液性脉络膜视网膜病变
autofluorescence - 自身荧光
cantholysis - 眦切开术
tarsorrhaphy - 睑缘缝合术
crocodile tears - 鳄鱼泪
fungal keratitis - 真菌性角膜炎
pterygium - 翼状胬肉
phoria - 隐斜
fundus fluorescein angiography - 荧光素眼底血管造影[术]
primary glaucoma - 原发性青光眼
keratoconus - 圆锥角膜
ocular injury - 眼外伤
ophthalmia - 眼炎
blepharoplasty - 眼睑成形术
ocular contusion - 眼挫伤
foreign body sensation - 异物感
endophthalmitis - 眼内炎
anterior vitrectomy - 眼前段玻璃体切割术
neovascular glaucoma - 新生血管性青光眼
form sense - 形觉
cyclotropia - 旋转斜视
ghost cell glaucoma - 血影细胞性青光眼
penalization - 压抑疗法
convex lens - 凸球镜片
aphakia - 无晶状体
undine - 洗眼壶
congenital cataract - 先天性白内障
congenital ptosis - 先天性上睑下垂
central retinal vein occlusion - 视网膜中央静脉阻塞
perimeter - 视野计
binocular diplopia - 双眼复视
binocular vision - 双眼视力
double eyelid operation - 双重睑术
with movement - 顺动
trabeculopuncture - 小梁穿刺术
trabeculectomy - 小梁切除术
strabismus - 斜视
visual angle - 视角
optic neuropathy - 视神经病变
optic neuritis - 视神经炎
diabetic retinopathy - 糖尿病[性]视网膜病变
anisocoria - 瞳孔不等
isocoria - 瞳孔等大
mydriasis - 瞳孔扩大
ischemic optic neuropathy - 缺血性视神经病变
artificial cornea - 人工角膜
implantation of artificial lens - 人工晶状体植入术
fusion - 融合
optic perineuritis - 视神经周围炎
retinopathy - 视网膜病变
retinoschisis - 视网膜劈裂症
retinitis pigmentosa - 视网膜色素变性
retinal edema - 视网膜水肿
divergence - 散开
chromatopsia - 色视症
trachoma - 沙眼
hypertropia - 上斜视
hyperphoria - 上隐斜
ptosis - 上睑下垂
retrobulbar hemorrhage - 球后出血
blindness - 盲
blind spot - 盲点
capsular cataract - 囊性白内障
cystoid macular edema - 囊样黄斑水肿
paracentral scotoma - 旁中心暗点
morning glory syndrome - 牵牛花综合征
hyphema - 前房积血
anterior chamber intraocular lens - 前房型人工晶状体
dacryocystorhinostomy - 泪囊鼻腔吻合术
stereoscope - 立体镜
filtering operation - 滤过术
chorioretinopathy - 脉络膜视网膜病变
capsulotomy - 晶状体囊切开术
lens - 镜片
corneal ulcer - 角膜溃疡
keratomileusis - 角膜磨削术
keratectomy - 角膜切除术
corneal edema - 角膜水肿
contact lens - 接触镜
conjunctival flap - 结膜瓣
conjunctival congestion - 结膜充血
muscular asthenopia - 肌性视疲劳
laser photocoagulation - 激光光凝术
scanning laser ophthalmoscope - 激光扫描检眼镜
laser trabeculoplasty - 激光小梁成形术
secondary glaucoma - 继发性青光眼
ophthalmoscopy - 检眼镜检查[法]
chemosis - 结膜水肿
conjunctivitis - 结膜炎
diamond knife - 金刚钻刀
scleral punch - 巩膜咬切器
light projection - 光定位
phosphene - 光幻视
light sense - 光觉
panretinal photocoagulation - 广泛视网膜光凝术
amaurosis - 黑●
iridocyclitis - 虹膜睫状体炎
iridectomy - 虹膜切除术
iridotomy - 虹膜切开术
iritis - 虹膜炎
corrected vision - 矫正视力
corneal leukoma - 角膜白斑
localizer - 定位器
contrast sensitivity - 对比敏感度
rate of flow - 房水生成速度
sutural cataract - 缝性白内障
diplopia - 复视
macular hole - 黄斑裂孔
filling defect - 充盈缺损
high myopia - 高度近视
accommodation - 调节
complicated cataract - 并发性白内障
vitreous degeneration - 玻璃体变性
intravitreal injection - 玻璃体内注射
vitrectomy - 玻璃体切割术
vitreoretinopathy - 玻璃体视网膜病变
drusen - 玻璃疣
orbital cellulitis - [眼]眶蜂窝织炎
orbital decompression - [眼]眶减压术
orbital emphysema - [眼]眶气肿
blepharospasm - [眼]睑痉挛
lid retraction - [眼]睑退缩
Amsler grid - 阿姆斯勒方格表
concave lens - 凹球镜片
cataract - 白内障
