科技百科

big data - 大数据
simulation software【计】 - 仿真软件
cosmic supervoid - 宇宙超巨洞
ResearchKit - （医学）研究套件
grassroots；grassroot guys；diaos - 屌丝；吊丝
niubility - 牛逼，牛B
gelivable - 给力
Maker - 创客
(数据)区块链 - blockchain
blockchain - (数据)区块链
Health Level Seven; HL7 - 卫生信息交换标准
ungelivable - 不给力
Creators - 创客
crowdfunding - 众筹
StreamComputing - 流计算
HoloLens - 微软全息眼镜
Clinical Data Acquisition Standards Harmonization (CDASH) - 临床数据获取标准协调
CDISC - the Clinical Data Interchange Standards Consortium - 临床数据交换标准协会
cloud computing - 云计算
WhatsApp - WhatsApp
Tech-free tourism - 零科技旅游
smart grid, intelligent grid - 智能电网
smart city - 智慧城市
three dimensional printing，3D printing - 三维打印
triple-networks convergence，triple-play - 三网融合
iron-based superconductor - 铁基超导体
quantum anomalous Hall effect - 量子反常霍尔效应
wireless sensor network - 无线传感器网络
nanomaterials green plate technology，NGP - 纳米材料绿色制版技术
virtual observatory，VO - 虚拟天文台
Mompetition - 拼孩
Fangirl/fanboy - 脑残粉
Showroom - 去实体店体验之后用更少的钱在网上购买
Pollotarian - 只吃白肉（家禽类）不吃红肉的素食主义者
Monster country - 超级大国
Eurogeddon - 非常严峻的欧洲危机
Cyberflaneur - 网络闲逛族
Downager - 装嫩的人；装萌的人
cross-dresser; newhalf - 伪娘
living together apart - 蜗婚
the rich second generation；the second-generation rich - 富二代
seckilling; instant killing - 秒杀
no-show - 失约（者），缺席（者），放鸽子
capsule apartment - 胶囊公寓
Virtual economy - 虚拟经济
Supply-side structural reform - 供给侧结构性改革
Blueprint on innovative growth - 创新增长蓝图
Actions speak louder than words - 行胜于言
First-mover advantage - 先发优势
Open Access - 开放获取
Food Contamination - 餐桌污染
Internet Plus - 互联网+
Belt and Road Initiative - 一带一路
New normal - 新常态
Historical starting point - 历史起点
Juncture - 节点
Green development - 绿色发展
shability - 傻逼力
google - 搜索
derivative - [数] 导数，微商; [化] 衍生物，派生物;
Livable - 宜居
curvilinear coordinate【数】 - 曲线坐标
cycloidal gear【机】 - 摆线齿轮
gallery【建】 - 廊台
rational basis【数】 - 有理基
rear wheel drive【车辆】 - 后轮驱动式
receiver【冶】 - 接料盘
rectangular【数】 - 有直角的
restitution【经】 - 恢复原状
membrane structure【建】 - 薄膜结构
stable platform【航】 - 稳定（仪表）平台
stalk【动】 - 肉柄
statistical method【数】 - 统计方法
stile【建】 - 窗梃
structural engineering【建】 - 结构工程
gas storage【油气】 - 储气
cycle variation【科技】;cyclical movement【经】 - 周期变化
separator【矿】 - 分选机
gas pressure【矿】 - 瓦斯压力
gas migration【矿】 - 瓦斯流动
gas leakage【矿】 - 瓦斯泄漏
gear hobbing【机】 - 滚齿
gate【建】 - 牌楼
overrelaxation【力】 - 过度松弛
overweight【交】 - 超重（的）
part program【机】 - 部件加工程序
veranda【建】 - 游廊
steamboat【船】 - 汽船
straight run【化工】 - 直馏馏分
water separator - 脱水器水分离器 
crooked - 弯曲的
bending die - 弯曲模 
bending test - 弯曲试验 
turbulent - 湍聊
surging - 湍振
ellipse - 椭圆
watt hour - 瓦时 
gas pipe - 瓦斯管 
watt hour - 瓦特小时 
external pressure - 外部压力 
outer race - 外环 
external load - 外加载 
cam mechanism - 凸轮机构 
cam profile - 凸轮轮廓 
pusher - 推出器
derivation - 推导
propellant - 推进剂
propelling force - 推进力 
Decap - 退底火
Annealing - 退火处理
Extraction - 退壳
Extractor - 退壳钩、退壳器
decoupling - 退耦
Heel - 托踝
escape velocity - 脱离速度 
boss - 凸起部
overhang - 突出
Assault rifle - 突击步枪 
plot - 图
DWG - 图(Drawing)
plot - 图表
graphical - 图示的
graphic - 图示的
graphic display - 图形显示器 
drawing number - 图纸号 
preservation - 涂防腐油
soil dynamics - 土动力学 
earth pressure - 土压力 
synchronism - 同步性
isomer - 同素异构体
concentricity - 同心性
polymorphism - 同质多晶现象
copper tube - 铜管 
copper alloy - 铜合金 
silo - 筒仓
bow wave - 头波 
projection - 投影
projector - 投影仪
turbine - 透平机
stuffing box - 填料函 
drill - 条播机;钻头
stapler - 铁丝钉书机
iron core - 铁芯 
retention time - 停留时间 
stop valve - 停止阀 
cam follower - 挺杆 
cockpit - 艇尾座
pass band - 通带 
collar - 凸边
extract - 提出物
after sales service - 提供维修服务 
advance - 提前
volume ratio - 体积比 
volume fraction - 体积率 
go side - 通端 
fan - 通风机
air hole - 通风孔 
breather - 通气管
aerator - 通气设备
communication satellite - 通讯卫星 
synchronism - 同步
hydrocarbon fuel - 碳氢燃料 
boring head - 镗戏 
Lead - 膛喉
Chamber - 膛室
Chamber pressure - 膛压 
escape velocity - 逃逸速度 
ceramic tool - 陶瓷车刀 
set - 套
volumetric efficiency - 体积效率 
gear shaving - 剃齿 
libration - 天平动
celestial mechanics - 天体力学 
astronomical telescope - 天体望远镜 
filler - 填充剂
precession - 岁差
breaking waves - 碎波 
tunnel kiln - 隧道式炉 
housing - 套
bush - 套筒
characteristic line - 特性线 
patent - 特许
trapezium - 梯形
mortise - 榫眼
locking - 锁定
locking - 锁住
footstep - 踏板
tread - 胎面
pedestal - 台
bench test - 台架试验 
state function - 态函数 
detection - 探测
flaw detector - 探伤仪 
hodograph method - 速端法 
speed control - 速率第 
mold base - 塑胶模座 
plastic body - 塑料车体 
plasticity - 塑性
plastic - 塑性的
plastic deformation - 塑性应变 
acid number - 酸价 
acid value - 酸价 
acid process - 酸性炼钢法 
arithmetic mean - 算术平均 
quadrangle - 四角形
sedan - 四门轿车
servo - 伺服电动机
servo actuator - 伺服执行机构 
delivery - 送出
blast - 送风
speed control - 速度第 
range of speed - 速度范围 
underwater explosion - 水中爆炸 
level - 水准仪
compliance - 顺度
clockwise rotation - 顺时针旋转 
direct motion - 顺行 
progressive die - 顺序冲模 
sequence control - 顺序控制 
velocity profile - 速度剖面图 
water flow - 水流 
FAC - 水龙头(Faucet)
watertight - 水密的
hydraulic power - 水能 
level sensor - 水平传感器 
transient response - 瞬态响应 
instantaneous axis - 瞬轴 
driver - 司机
fireman - 司炉
cableway - 死
dead center - 死点 
quadrilateral - 四边形
horizontal projection - 水平投影 
water head - 水头 
water mass - 水团 
water consumption - 水消费量 
hydraulic riveting - 水压铆接 
hydraulic test - 水压试验 
charge - 炉料
burden - 炉料
grate area - 炉箧积 
stove heating - 炉子供暖 
tape recorder - 录音机 
cake - 滤饼
bag filter - 滤袋式滤清器袋式滤器 
filter element - 滤过篇件 
subgrade - 路基
aluminum rivet - 铝铆钉 
alumina - 铝氧土
aluminum oxide - 铝氧土 
crawler - 履带
crawler tractor - 履带拖拉机 
disorientation - 乱取向
tire - 轮箍
wheel rim - 轮箍 
tyre - 轮箍;轮胎
wheel track - 轮距 
profile - 轮廓
outline - 轮廓
profile grinding - 轮廓磨削 
pour point - 零 
zero shift - 零点漂移 
parts list - 零件表 
rheological behavior - 龄行为 
rheological equation - 龄学方程 
flow theory - 另论 
flow - 流
current - 流
runner - 流道
direction of flow - 硫 
efflux - 瘤
run off - 瘤 
spout - 瘤口
discharge rate - 瘤速率 
turret - 六角刀架
inflation - 轮胎阀
tire valve - 轮胎阀 
gantry crane - 龙门起重机 
tap - 龙头
bulge - 隆起
funnel - 漏斗;烟囱
leakage - 漏泄
leak - 漏泄
dew point hygrometer - 露点湿度表 
lining - 炉衬
oscillation system - 振荡系 
shaking - 振动
vibration exciter - 振动发生器振动激励器 
shaker - 振动机
vibration acceleration - 振动加速度 
reduced pressure - 折算压力 
broken line - 折线 
frog - 辙岔
vacuum forming - 真空成形 
vibration isolation - 振动绝缘 
vibration theory - 振动理论 
diaphragm - 振动膜
vibration plane - 振动平面 
vibrator - 振动器振子
vibration test - 振动试验 
vibrating table - 振动台 
vibration system - 振动系统 
shake down - 振动硬化 
vacuum filter - 真空过滤机 
vacuum diffusion - 真空扩散 
vacuum state - 真空态 
vacuum system - 真空系统 
discriminator - 甄别器鉴相器
tie - 枕木
blast of wind - 阵风
oscillating circuit - 振荡回路 
oscillation damping - 振荡减幅 
oscillation frequency - 振荡频率 
underpinning【建】 - 基础加固
underground tank【建】 - 地下槽
unique solution【数】 - 唯一解
rounding【机】 - 制圆
rolling【航】 - 侧滚振动
seaming【机】 - 卷边接合
asymptotic rate of convergence【数】 - 渐近敛速
automotive engineering【车辆】 - 机动车工程
availability【船】 - 轮船使用的期限
backlash【机】 - 轮齿隙
bay【建】 - 开间
batch【玻璃】 - 配合料
homogenate【生化】 - 匀浆
boiler pressure【动力】 - 锅炉蒸汽压力
bored pile【建】 - 钻孔桩
brake lining【车辆】 - 闸衬片
hydrocracking【油气】 - 加氢裂化
buck【矿】 - 试样研磨
carp【航】 - 轰炸瞄准具的制导附件
contributory【法】 - 负连带偿还责任的人
contributor【经】 - 资助国
counting system【经】 - 计数制
crack tip【力】 - 裂纹尖端
coal mine geology【矿】 - 煤矿地质学
coal rank【矿】 - 煤级
engagement【妇产】 - 衔接
error ellipse【数】 - 误差椭圆
evaluation【数】 - 计值
capital contribution【经】 - 资本捐赠
pairwise【数】 - 两两的
papillary thyroid carcinoma【肿瘤】 - 乳头状甲状腺癌
御夫座β【天】 - β Aur
legal entity【法】 - 法律实体
leukotriene【生化】 - 白三烯
patter【建】 - 镘板
loop【古生】 - 环台面
Riedel's disease【内科】 - 里德耳氏病
rolling mill【机】 - 轧钢厂
rotor speed【机】 - 转子转速
runway【航】 - 跑道
heterogeneity【矿】 - 不均质性
residual gas【化工】 - 残余气体
rheological property【力】 - 流变性质
rolling diameter【机】 - 滚圆直径
target area【军】 摄 - 目标区
tanker【油气】 - 油轮
coordinate data【数】 - 坐标数据
pilotless - 无人驾驶的
silent chain - 无声传动链 
nullification - 无效
centerless grinding - 无心磨削 
absorber - 吸收剂
absorption refrigerator - 吸收式冷冻机 
water absorption - 吸水酌 
pyrometric cone - 蜗测温三角锥 
Grip - 握把
pollution control - 污染防治 
roof truss - 屋顶架 
unstressed - 无应力的
oil free compressor - 无油压缩机 
weightlessness - 无重力
vorticity - 涡量
seamless - 无缝的
jointless - 无缝的
seamless tube - 无缝管 
reactive power - 无功功率 
nonporous - 无孔的
blind flange - 无孔法兰盘 
frictionless - 无摩擦的
eddy - 涡流旋流
turbogenerator - 涡轮发电机
turboprop - 涡轮螺旋桨发动机
turboprop aircraft - 涡轮螺旋桨飞机 
turbocharger - 涡轮增压器
vortex - 涡旋
formation of eddy - 涡旋形成 
position sensor - 位置检测器位置传感器 
positional control - 位置控制 
position control - 位置控制 
temperature measurement - 温度测量 
thermograph - 温度记录机
THS - 温度开关(Thermostat)
increase of temperature - 温度上升 
turbulent - 紊聊
turbulent flow - 紊流湍流 
turbulence - 紊乱
permanent wave - 稳定波 
direction angle - 方向角 
sense - 方向
normal component - 法向分量 
normal - 法线
weight - 法码
flange gasket - 法兰垫片 
valve body - 阀体 
valve - 阀,闸门
discovery - 发现
flight performance - 飞行特性 
flight simulator - 飞行模拟机 
flight path - 飞行路径 
bearing - 方位;轴承
van der waals force - 范德瓦耳斯力
counteraction - 反酌
reversing - 反转
reactor vessel - 反应堆容器 
reaction pressure - 反压 
backpressure - 反向压力;反压力
nonlinear system - 非线性系 
aircraft engine - 飞机发动机 
aerodrome - 飞机场
plane - 飞机
gutter - 放水沟
radiator - 放热器散热器
vent - 放气孔
purging - 放气
power gain - 放大系数 
intensifier - 放大器倍增器
enlargement scale - 放大标度 
enlargement - 放大
drain pipe - 放出管 
release - 放出
simulation model - 仿真摸型 
profiling - 仿形切削
scatter - 分散
nonlinear theory - 非线性理论 
nonlinear programming - 非线性规划 
nonlinear equation - 非线性方程 
nonequilibrium state - 非平衡状态 
disequilibrium - 非平衡
nonequilibrium - 非平衡
amorphous alloy - 非晶质合金 
asymmetry - 非对称性
unsteady flow - 非定常流不稳定流 
unsteady flow - 非定常流 
anharmonic - 非低的
diversion - 分流
manifold - 分淋
splitting - 分裂
air hammer - 空气锤 
air wave - 空气波 
caving - 空泡形成
space distribution - 空间分布 
xenobiotic metabolism【生化】 - 异生物质代谢
white cement【建】 - 白水泥
welding cable【机】 - 焊接缆线
weakness【经】 - 疲软
weathering【建】 - 泻水波
water hammer【矿】 - 水锤现象
violation【法】 - 犯法
verruca【昆】 - 毛瘤
valve【机】 - 滑盖开关
center height - 中心高度 
central point - 中心点 
central line - 中线 
quill - 中空轴
intermediate support - 中间支点 
mesosphere - 中间层
cultivator - 中耕除草机
medium pressure - 中等压力 
gravitational energy - 重力能 
gravity flow - 重力流 
gravity separation - 重力分离 
gravity anomaly - 重力反常 
gravimetry - 重力测量
gravity wave - 重力波 
gravity dam - 重力坝 
gravitational force - 重力 
force of gravity - 重力
repeated load - 重复载荷 
repeatability - 重复精度
planter - 种植器播种机
mass spectrometer - 质谱分析器 
barycenter - 质量中心
bearing clearance - 轴承间隙 
bearing load - 轴承荷载 
raceway grinding machine - 轴承滚道磨床
bearing load - 轴承负载 
environment temperature - 周围温度 
ambient air - 周围空气 
final state - 终态 
terminal velocity - 终速 
central control - 中央控制 
neutral plane - 中性面 
spindle - 主轴
main pipe - 主管道 
Bead - 珠状准星
pearlite - 珠光体
elbow joint - 肘接 
belt cover - 护带罩 
circulation index - 环粮数 
ambient conditions - 环境条件 
reduction - 还原;压下量
scribing - 画线
drawing board - 画图板 
scriber - 划线针
cod - 化学需氧量
cm - 化学铣切
heavy plate - 厚板 
trailing edge - 后缘 
rear suspension - 后悬挂装置 
Butt - 后托、枪托同“后托”(buttstock)。
back view - 后视图 
rear drive - 后轮传动 
restoring force - 回复力 
recovery - 回复
resilience - 回弹能
back substitution - 回代 
chb - 化学切料
traveller - 滑柱
slip line - 滑移线 
glide - 滑移
taxiing - 滑行
slip ring - 滑环 
sliding resistance - 滑动阻力 
slip resistance - 滑动阻力 
sliding door - 滑动门 
slip ratio - 滑动比 
slide - 滑动
repercussion - 回冲击反撞
back stroke - 回程 
brightness - 辉度
luminance - 辉度
volatile component - 挥发分 
gray body - 灰色体 
spring coil - 簧圈 
reduced pressure - 换算压力 
shift - 换班
buffer - 缓冲器减震器
shock absorber - 缓冲器缓冲装置 
damper spring - 缓冲弹簧 
Baffle - 缓冲板
Epoxy - 环氧树脂
annular space - 环形间隙 
ring bolt - 环首螺栓 
mixing length - 混合长度 
plotter - 绘图仪
plotting - 绘图
rotary motion - 回转运动 
experimental result - 实验结果 
dummy - 实体模型
know how - 实际知识 
full scale - 实际缩尺 
actual size - 实际尺寸 
ageing - 时效
time behavior - 时间行为 
rope - 绳
contraction ratio - 收缩比 
retreat - 收缩
trap - 收集器
serviceability - 适用性
compliance - 适应性
adaptive control - 适应控制 
outdoor temperature - 室外温度 
tile - 饰面花砖
running in - 试转 
test specimen - 试样 
specimen - 试样
tester - 试验仪器
test cock - 试验旋塞 
test stand - 试验台 
test point - 试验点 
test car - 试验车 
pilot production - 试生产 
test run - 试车 
trial run - 试车 
view - 视图
time average - 时间平均 
pivot - 枢轴
heating surface - 受热面 
forced vibration - 受迫振荡 
excited atom - 受激原子 
Handloading - 手制子弹
potential flow - 势流位流 
numerator - 示号器
indicator - 示功器;指示器
service life - 使用寿命 
dying out - 衰灭消失 
fading period - 衰落周期 
decay rate - 衰减率 
decrement - 衰减率
decay - 衰减
brushing - 刷净
digital servo - 数字伺服 
digitization - 数字化
nc lathe - 数值控制车床 
nc - 数值控制
numerical analysis - 数值分析 
spray gun - 手枪式喷漆器喷漆枪 
centerless grinding - 无心磨削 
nullification - 无效
silent chain - 无声传动链 
pilotless - 无人驾驶的
coordinate data【数】 - 坐标数据
tanker【油气】 - 油轮
target area【军】 摄 - 目标区
control loop - 控制回路 
control mode - 控制方式 
control valve - 控制阀 
control circuit - 控制电路 
control cabinet - 控制舱 
control button - 控制按钮 
pass - 孔型
pore water pressure - 孔隙水压力 
porewater - 孔隙水
void space - 孔隙空间 
slippage - 空转
idling - 空运转
idle time - 空闲时间 
void ratio - 空隙率 
void fraction - 空隙率 
cavitation erosion - 空隙腐蚀 
vacancy - 空位
air speed indicator - 空速指示器空速表示器 
aneroid barometer - 空盒气压表 
empty - 空的
Blank - 空包弹
liner - 客轮
frame structure - 框架结构 
deficit - 筐
fast breeder - 快增殖反应堆 
yacht - 快艇
quick return - 快速退刀 
fft - 快速傅里叶变换
quick freezing - 快速冻结 
cavity - 空腔
air damper - 空气阻尼器 
pneumatic brake - 空气制动器 
air pressure test - 空气压力试验 
air tank - 空气箱 
air jet - 空气喷嘴 
tensile force - 拉力 
take up - 拉紧装置 
quick action - 快动的 
rapid - 快的
coulomb friction - 库仑摩擦 
tightening - 扣紧
caliber - 口径;孔型
Calibre - 口径
space shuttle【航】 - 空间飞机
source level【声】 - 声源级
social security fund【财政】 - 社会保障基金
confocal【数】 - 共焦的
collusion【法】 - 串通舞弊
necessary【数】 - 必要的
mixer【建】 - 拌和机
miner【矿】 - 采矿工
algebraic differential equation【数】 - 代数微分方程
exponential function【数】 - 指数函数
exotic【植】 - 引进的植物
variable charge【土壤】 - 可变电荷
cosine function【数】 - 余弦函数
column【化工】 - （蒸馏或萃取）塔
solenoid - 螺线管线圈
spiral - 螺线
number of threads - 螺纹扣数 
motor oil - 马达油 
fall - 落下
tup - 落锤
thread - 螺纹
bolt hole - 螺栓孔 
screw pitch - 螺距 
logic element - 逻辑单元 
wheel and axle - 轮轴 
flange - 轮缘;凸缘
wheel flange - 轮缘 
rim - 轮缘
pulse height - 脉冲高度 
fall - 落差
head - 落差
helix - 螺旋线
spiral staircase - 螺旋梯 
propeller blade - 螺旋桨叶 
prop - 螺旋桨
spinner - 螺旋毂盖
coiled spring - 螺旋弹簧 
pulse generator - 脉冲发生器脉冲振荡器 
Magnum - 麦格农
mach line - 马赫线 
dolly - 铆钉撑锤
rivet - 铆钉;铆接
blank - 毛坯
slug flow - 慢流 
full load operation - 满载运行 
high tide - 满潮 
pulse jet - 脉动式喷气发动机 
pulsed flow - 脉动流 
pulsation - 脉动
pulsing - 脉动
η２０５０共振【高能】 - η 2050 resonance
λ notation【数】 - λ记法
λ wave【流】 - λ型波
λ变量【数】 - λ variable
λ表达式【计】 - λ expression
λ参数【数】 - λ parameter
λ超子【高能】 - λ hyperon
λ调度法【管理】 - λ dispatch
γ射线散射【量子】 - γ-ray scattering
γ－谷氨□循环【生化】 - γ-glutamyl cycle
γ控制器【自】 - γ controller
β射线探测器【核】 - β-ray detector
β吸收厚度计【核】 - β-absorption ga(u)ge
γ球蛋白【免疫】 - γ globulin
γ射线传感器【自】 - γ-ray sensor
α生育酚【生化】 - α-tocopherol
α衰变能量【核】 - α-decay energy
α氧化【生化】 - α-oxidation
α－β搜索【计】 - α-β search
α递归论【数】 - α-recursion theory
α放射性的【核】 - α-active
α-fetoprotein【生化】 - α胎甲球蛋白
α And【天】 - 仙女座α
knock-off - 山寨
Chill out - 淡定
All is vanity - 神马都是浮云
biological carbon pump - 生物碳泵
extra spatial dimension - 额外空间维度
biophotonics - 生物光子学
Hawking radiation - 霍金辐射
Qigong - 气功
aquascape - 水景
dumbfounded - 囧
spermatophore【动】 - 精子包囊
space shuttle【航】 - 空间飞机
source level【声】 - 声源级
social security fund【财政】 - 社会保障基金
confocal【数】 - 共焦的
collusion【法】 - 串通舞弊
point cloud data - 点云数据
microfluidic chip - 微流控芯片
revealed - 显示
Android - 安卓系统
typewriting - 输入法
quantum computing - 量子计算
ultrafilter【化工】 - 超滤器
transportation equipment【交】 - 运输设备
toilet【建】 - 卫生间
tilbury【车辆】 - 轻便两轮马车
industrial noise【环境】 - 工业噪声
reset - 复原;重调重新蝶
upper atmosphere - 高层大气 
port - 港
steel wool - 钢丝棉 
reinforcement - 钢筋
steel structure - 钢结构 
steel construction - 钢结构 
rail - 钢轨
corundum - 刚玉石
stiffness - 刚性
stiffness matrix - 刚度矩阵 
rigidity - 刚度
stiffness - 刚度
EA - 个,只(计量单位)(Each)
soundproof material - 隔音材料 
spacer - 隔离片
bulkhead - 隔壁
anisotropic - 蛤异性的
isotropism - 蛤同性
header - 割穗机;顶锻机;集管
cutting torch - 割炬 
high voltage - 高压 
high efficiency - 高效率 
high speed wind tunnel - 高速风洞
high speed - 高速的 
high speed - 高速 
working characteristic - 工棕性曲线 
working load - 工棕荷 
i iron - 工字钢 
hydraulic oil - 工淄 
working temperature - 工茁度 
shop drawing - 工准 
working fluid - 工缀体 
working pressure - 工坠力 
operating time - 工妆间 
bench - 工专
table - 工专
working stress - 工爪力 
process controller - 工艺过程控制装置 
industrial boiler - 工业用锅炉 
industrial standard - 工业标准 
motion study - 工时标定 
tool breakage - 工具破损 
sharpener - 工具磨床;刃磨工
jolting - 震压造型
oscillator - 振子
shaking out - 振摇萃取 
singing - 振鸣
vibrational state - 振动状态 
vibration amplitude - 振动振幅 
detailing - 详细设计
detail drawing - 详图 
part drawing - 详图 
phase transformation - 相变 
restrict - 限制
margin - 限界
inclined plane - 斜面 
shoot - 斜沟
slope - 斜度
helical gear - 斜齿轮 
chute - 斜槽
pointing - 镶
box - 箱子
phase shift - 相移 
dependence - 相依性
phase noise - 相位噪声 
phase difference - 相位差 
deformation - 形变
running gear - 行走装置 
efficiency curve - 效率曲线 
billet - 小钢坯
UR - 小便斗(Urinal)
pin - 销钉
key - 销;键
vanishing - 消失
trimmer - 修整器蝶器
repairman - 修配工
fitting - 修配
y connection - 星形连接 
signal to noise ratio - 信噪比
information base - 信息库 
firewood - 薪材
new energy - 新能源 
chaplet - 芯撑
pressure relief - 卸压 
leak detection - 泄漏探测 
harmonic oscillator - 谐振子 
harmonic vibration - 谐振动 
harmonic drive - 谐波传动 
harmonic - 谐波
ship repair - 修船 
property - 性质
performance index - 性能指标 
performance characteristic - 性能特性曲线 
performance - 性能
core making - 型芯制造 
stem - 型管电极电解加工
shape mill - 型钢轧机 
form factor - 形状系数 
form - 形状
escape velocity - 逃逸速度 
Chamber pressure - 膛压 
Chamber - 膛室
Lead - 膛喉
boring head - 镗戏 
hydrocarbon fuel - 碳氢燃料 
synchronism - 同步
communication satellite - 通讯卫星 
aerator - 通气设备
breather - 通气管
air hole - 通风孔 
fan - 通风机
go side - 通端 
volume fraction - 体积率 
volume ratio - 体积比 
advance - 提前
after sales service - 提供维修服务 
extract - 提出物
collar - 凸边
pass band - 通带 
cockpit - 艇尾座
cam follower - 挺杆 
stop valve - 停止阀 
retention time - 停留时间 
iron core - 铁芯 
stapler - 铁丝钉书机
drill - 条播机;钻头
stuffing box - 填料函 
turbine - 透平机
projector - 投影仪
projection - 投影
bow wave - 头波 
silo - 筒仓
copper alloy - 铜合金 
copper tube - 铜管 
polymorphism - 同质多晶现象
concentricity - 同心性
isomer - 同素异构体
synchronism - 同步性
earth pressure - 土压力 
soil dynamics - 土动力学 
preservation - 涂防腐油
drawing number - 图纸号 
graphic display - 图形显示器 
graphic - 图示的
graphical - 图示的
plot - 图表
DWG - 图(Drawing)
plot - 图
Assault rifle - 突击步枪 
precast concrete【建】 - 预制混凝土构件
prestressed concrete【建】 - 预应力混凝土
almost all【数】 - 几乎所有
alternative【科技】 - 待用物
g【计量】;gram(=gramme)【计量】 - 克
order【军】 - 队形
Floor plate - 弹仓底板 
elastic stress - 弹性应力 
elastic buckling - 弹性压曲 
elastic strain - 弹性形变 
elastic deformation - 弹性形变 
elastic coefficient - 弹性系数 
elastic stability - 弹性稳定性 
elastic stability - 弹性稳定 
modular construction - 单元结构 
single row - 单排的 
elastic energy - 弹性能 
spring back - 弹性回复 
assembled【机】 - 装配的
buttering【建】 - 镘刀涂砂浆
octave【声】 - 倍频程
non-stop flight【航】 - 不着陆飞行
notarization【法】 - 公证
mastitis【妇产】 - 乳房炎
just【法】 - 公正的
white metal - 白合金 
Lane - 靶道
taper pin - 拔锥梢/锥形梢 
driving plate - 拔盘 
draft - 拔模锥度
poker - 拔火棍
octagonal - 八角形的
octagon - 八角形
gib - 凹形拉紧
female die - 凹模 
nick - 凹口
pitting - 凹痕
bow - 凹度
assembling - 安装
erection - 安装
setting - 安装
safeguard - 安全装置
safety factor - 安全因数 
safety factor - 安全系数 
safety regulations - 安全规则 
safety precaution - 安全措施 
avometer - 安伏欧计
alnico - 阿尔尼科合金
x engine - x形发动机 
construction - work施工工程
obstruction - 障碍
Derringer - 掌心雷
tensor field - 张量场 
tensor - 张量
tensile force - 张力 
aspect ratio - 展弦比 
expansion plan - 展开图 
expand - 展开
chopping - 斩
adhesion coefficient - 粘着系数 
polynucleotide【生化】 - 多核□酸
rolling guide - 滚动导轨 
roll wave - 滚动波 
race - 滚道
generating process - 滚成法 
rail brake - 轨闸 
orbiting - 轨道运动
excess air - 过剩空气 
supercharger - 过给器
excess load - 过负荷 
transition temperature - 过渡温度 
transition period - 过渡时期 
transient loading - 过渡加载 
process control - 过程控制 
orbit - 轨道
pathway - 轨道
track - 轨道
trajectory - 轨道
normalization - 归一化
aviation fuel - 航空燃料 
avionics - 航空电子学
iso - 国际标准化组织
boiler flue - 锅炉烟道 
boiler house - 锅炉房 
ball cage - 滚珠轴承分离环 
ball screw - 滚珠螺杆 
roller bearing - 滚轴支座 
tumbling - 滚筒清理法
tumbler - 滚光筒
barreling - 滚光
antifriction bearing - 滚动轴承 
rolling load - 滚动载荷 
welded construction - 焊接结构 
welding robot - 焊接机扑 
welding current - 焊接电流 
bead - 焊道
gamma function - 函数 
water content - 含湿量 
ocean wave - 海洋波 
sea wave - 海洋波 
boundary conditions - 边界条件 
boundary - 边界
boundary layer - 边层 
arm - 边
boom - 臂
lightning conductor - 避雷针 
closed cycle - 闭路循环 
specific resistance - 比阻力 
specific speed - 比速率 
specific speed - 比速 
specific strength - 比强度 
hydrometer - 比量计
proportional control - 比例控制 
specific power - 比功率 
resistivity - 比电阻
specific surface - 比表面 
pumping pressure - 泵压力 
pumpability - 泵送能力
pump head - 泵的压头 
collapse - 崩溃
multiple - 倍数
back pressure - 背压力 
back pressure - 背压 
repair parts - 备件 
spare - 备件
explosive working - 爆炸加工 
puncture - 爆坏
detonation wave - 爆轰波 
outburst - 爆发
warning device - 报警装置 
service personnel - 保修人员 
lagging - 保温
conformal mapping - 保角映射 
protective device - 保护装置 
guard - 保护装置
shielding gas - 保护气体 
holding time - 保持时间 
wrapper - 包装机
packing list - 包装单 
envelope - 包络线
coating - 包复
covering - 包复
steam condenser - 棒式松砂机 
bar steel - 棒钢 
wake - 伴流
button head - 半圆头 
office computer - 办公计算机 
plate structure - 板结构 
Disconnector - 扳机脱离钩
pendulum effect - 摆效应 
solid control      - 净化技术
plastic cement      - 塑性水泥
oil can      - 油壶
disk cam      - 盘形凸轮
conjugate cam      - 共轭凸轮
disc brake      - 圆盘制动器
synchronous belt      - 同步带
seal belt      - 密封带
flat belt      - 平带
mechanical behavior      - 机械特性
back angle      - 背锥角
statistics analysis      - 统计分析
quantitative analysis      - 大量分析
empirical analysis      - 经验性总结分析
line along      - 排列
polyvinyl alcohol      - 聚乙烯醇(PVA)
ecology environment      - 生态环境
nominal diameter      - 公称直径
technological design      - 工艺设计
structural design      - 结构设计
creation design      - 创新设计
brief description      - 简介
pitch curve      - 理论廓线
electric conductivity      - 电导率
assembly condition      - 装配条件
formation communication      - 连通性
fractional column      - 精馏塔
lost circulation      - 井漏
lost circulation      - 漏失
calcium chloride      - 氯化钙(CaCl2)
dynamic characteristics      - 动态特性
silent chain      - 齿形链、无声链
working fluid      - 入井液
viscous fluid      - 粘性流体
pore fluid      - 孔隙液
polymer flocculant      - 高分子絮凝剂
velocity field      - 速度场
form factor      - 齿形系数
heat exchanger      - 换热器
drying equipment      - 干燥设备
volume distribution      - 体积分布
reasonable distribution      - 合理级配
carbon dioxide      - 二氧化碳（CO2）
primary investigation      - 初探
buried hill      - 潜山
bevel gears      - 圆锥齿轮机构
worm gearing      - 蜗杆传动机构
ring gear      - 内齿圈
helical gear      - 斜齿圆柱齿轮
circular gear      - 圆形齿轮
workshop - 车间
frame - 车架;机架;肋骨
coupler - 车钩
lathe work - 车工工作 
carrier - 车床夹子
tidal wave - 潮汐波 
overrun - 超限运动
ultrasonic testing - 超声波探伤法 
superhigh pressure - 超高压 
vlsi - 超大规模集成电路
fet - 场效应晶体管
field theory - 场沦 
plant - 厂
Long stroke - 长气体活塞行程 
rectangle - 长方形
long ton - 长吨 
length measuring - 长度测量 
long wave - 长波 
chatter mark - 颤痕 
chatter - 颤动
bucket - 铲斗
relieving - 铲
generation - 产生
Aperture - 觇孔
demolition - 拆除
differential pressure - 差压 
difference equation - 差分方程 
difference method - 差分法 
fork truck - 叉式自动装卸车 
laminate - 层压板
laminar - 层聊
sandwich - 层叠物
anvil - 测砧
time measurement - 测时 
measured value - 测量值 
measuring apparatus - 测量仪器 
measuring device - 测量设备 
measuring machine - 测量机 
measuring point - 测量点 
dynamometer - 测力计
odometer - 测距仪
log - 测程仪
measure - 测
skid - 侧向滑动
flank - 侧面
lateral force - 侧力 
outside loop - 侧飞翻斗 
sketch - 草图
channel - 槽钢
tank - 槽
wheel track - 轮距 
tyre - 轮箍;轮胎
wheel rim - 轮箍 
tire - 轮箍
disorientation - 乱取向
crawler tractor - 履带拖拉机 
crawler - 履带
aluminum oxide - 铝氧土 
alumina - 铝氧土
aluminum rivet - 铝铆钉 
subgrade - 路基
filter element - 滤过篇件 
bag filter - 滤袋式滤清器袋式滤器 
cake - 滤饼
tape recorder - 录音机 
stove heating - 炉子供暖 
grate area - 炉箧积 
burden - 炉料
charge - 炉料
shot - 弹丸
Crane - 弹筒吊杆
catapult - 弹射器弹射装置
catapult - 弹射器
elastic force - 弹力 
Clip - 弹夹
recoil - 弹回
elastic ring - 弹簧圈 
spring model - 弹簧模型 
reciprocal - 倒数;相互的;反的
guide pin - 导销 
guide hole - 导向孔 
land - 导向边
margin - 导向边
guidance - 导向
guide pin - 导梢 
guide wall - 导邻 
third rail - 导电轨 
guide plate - 导板 
tip - 刀片
tips - 刀片
uniform velocity - 等速度 
equidimensional - 等量纲的
plasma torch - 等离子体喷枪 
plasma instability - 等离子体不稳定性 
plasma - 等离子体
cutter holder - 刀夹 
frequency modulation - 档 
slinger - 挡油环
heat shield - 挡热板 
fender - 挡泥板
construction - 结构
icing - 结冰
pitch angle - 节锥角 
fuel economy - 节约燃料 
economy - 节省
energy conservation - 节能 
throttle - 节流阻气
choking - 节流
restriction - 节流
restrictor - 节僚
pitch - 节距
connector. - 接线器
connection box - 接线盒 
flange gasket - 接盘垫;接盘垫 
focal distance - 焦点距离 
flap - 襟翼
metal saw - 金属用锯 
metal ceramic - 金属陶瓷 
canister - 金属容器罐
metal forming - 金属成形 
metal sheet - 金属板 
metallography - 金相学
bort - 金刚石屑
carborundum wheel - 金刚砂轮 
limit - 界限
grounding - 接地
contact friction - 接触摩擦 
contact cooling - 接触冷却 
immersion - 浸入
leaching - 浸出
air intake - 进气口 
admission - 进气
supply pipe - 进料管 
permittivity - 介电常数
analytic - 解析的
depolymerization - 解聚酌
solution - 解
interception - 截击
crystal structure - 结晶结构 
crystal lattice - 结晶格子 
net force - 净力 
warning light - 警报灯 
headgear - 井架
well pump - 井泵 
fine adjustment - 精细蝶 
accuracy - 精确度
precision measurement - 精确测量 
exactitude - 精确
feed speed - 进给速度 
feeding speed - 进给速度 
Elevation - 高低调整
high - 高的
dryer - 干燥器
trunk - 干线
interference fit - 干涉配合 
interferometry - 干涉法
dry friction - 干磨擦 
destructive distillation - 干馏 
dry air - 干空气 
lid - 盖
modification - 改良
improver - 改进剂
rich gas - 富气 
auxiliary transmission - 副变速器 
reset - 复原;重调重新蝶
upper atmosphere - 高层大气 
port - 港
steel wool - 钢丝棉 
reinforcement - 钢筋
steel structure - 钢结构 
steel construction - 钢结构 
rail - 钢轨
corundum - 刚玉石
stiffness - 刚性
stiffness matrix - 刚度矩阵 
rigidity - 刚度
stiffness - 刚度
EA - 个,只(计量单位)(Each)
soundproof material - 隔音材料 
spacer - 隔离片
bulkhead - 隔壁
anisotropic - 蛤异性的
isotropism - 蛤同性
header - 割穗机;顶锻机;集管
cutting torch - 割炬 
high voltage - 高压 
high efficiency - 高效率 
high speed wind tunnel - 高速风洞
high speed - 高速的 
high speed - 高速 
working characteristic - 工棕性曲线 
working load - 工棕荷 
i iron - 工字钢 
hydraulic oil - 工淄 
working temperature - 工茁度 
shop drawing - 工准 
working fluid - 工缀体 
working pressure - 工坠力 
operating time - 工妆间 
bench - 工专
steady - 稳定的
permanent wave - 稳定波 
turbulence - 紊乱
turbulent flow - 紊流湍流 
turbulent - 紊聊
increase of temperature - 温度上升 
THS - 温度开关(Thermostat)
thermograph - 温度记录机
temperature measurement - 温度测量 
position control - 位置控制 
positional control - 位置控制 
position sensor - 位置检测器位置传感器 
formation of eddy - 涡旋形成 
vortex - 涡旋
turbocharger - 涡轮增压器
turboprop aircraft - 涡轮螺旋桨飞机 
turboprop - 涡轮螺旋桨发动机
turbogenerator - 涡轮发电机
eddy - 涡流旋流
frictionless - 无摩擦的
blind flange - 无孔法兰盘 
nonporous - 无孔的
reactive power - 无功功率 
seamless tube - 无缝管 
jointless - 无缝的
seamless - 无缝的
vorticity - 涡量
weightlessness - 无重力
oil free compressor - 无油压缩机 
unstressed - 无应力的
roof truss - 屋顶架 
pollution control - 污染防治 
Grip - 握把
pyrometric cone - 蜗测温三角锥 
water absorption - 吸水酌 
absorption refrigerator - 吸收式冷冻机 
absorber - 吸收剂
centerless grinding - 无心磨削 
nullification - 无效
silent chain - 无声传动链 
pilotless - 无人驾驶的
coordinate data【数】 - 坐标数据
tanker【油气】 - 油轮
target area【军】 摄 - 目标区
high sea【海洋】 - 狂浪
head【车辆】 - 汽车顶
globular protein【生化】 - 球状蛋白质
inlet velocity【航】 - 进口速度
indirect proof【数】 - 间接证明
horsehead【矿】 - 超前纵梁
logarithmic decrement - 对数衰减率 
logarithmic mean temperature difference - 对数平均温差
convector - 对僚热器
stacker - 堆积输送器
forge - 锻工炉
blacksmith - 锻工
calcining kiln - 煅烧炉 
ticker - 断续器
rupture test - 断裂试验 
multiple source - 多束源 
porous material - 多孔性材料 
polycrystalline material - 多晶物质 
sandwich material - 多层结构材料 
sandwich - 多层结构材料
composite plating - 多层电镀 
sandwich plate - 多层板 
blunt - 钝的
incommensurability【数】 - 不可通约性
wafer【机】 - 触片
ocean engineering【海洋】 - 海洋工程学
foaming agent【助剂】 - 发气剂
filing【机】 - 锉削
cell【航】 - 机翼构架
bumblebee【昆】 - 熊蜂
breaker【海洋】 - 浪花
bearing pressure【力】 - 支承压力
bearing structure【建】 - 承重结构
battleship【船】 军 - 战列舰
Y search【航】 - Ｙ形搜索
wind rose【气象】 - 风玫瑰（图）
wind turbine【动力】 - 风力涡轮机
volume【声】 - 音响强度
hydraulic fracturing【矿】 - 高压水砂破裂法
harrier【鸟】 - 鹞
ring width【机】 - 套圈宽度
hammering【机】 - （金属表面的）锤印
hand【脊椎】 - （猿猴的）脚
electric starter【车辆】 - 电启动器
air purification - 空气净化 
air cleaning - 空气净化 
air conditioner - 空气第器 
air hammer - 空气锤 
air wave - 空气波 
caving - 空泡形成
space distribution - 空间分布 
xenobiotic metabolism【生化】 - 异生物质代谢
white cement【建】 - 白水泥
welding cable【机】 - 焊接缆线
weakness【经】 - 疲软
weathering【建】 - 泻水波
shaking - 振动
oscillation system - 振荡系 
lining - 炉衬
dew point hygrometer - 露点湿度表 
leak - 漏泄
leakage - 漏泄
funnel - 漏斗;烟囱
bulge - 隆起
tap - 龙头
gantry crane - 龙门起重机 
tire valve - 轮胎阀 
inflation - 轮胎阀
turret - 六角刀架
discharge rate - 瘤速率 
spout - 瘤口
run off - 瘤 
efflux - 瘤
direction of flow - 硫 
runner - 流道
current - 流
flow - 流
flow theory - 另论 
rheological equation - 龄学方程 
rheological behavior - 龄行为 
parts list - 零件表 
zero shift - 零点漂移 
pour point - 零 
profile grinding - 轮廓磨削 
outline - 轮廓
profile - 轮廓
wheel track - 轮距 
tyre - 轮箍;轮胎
wheel rim - 轮箍 
tire - 轮箍
disorientation - 乱取向
crawler tractor - 履带拖拉机 
crawler - 履带
aluminum oxide - 铝氧土 
alumina - 铝氧土
aluminum rivet - 铝铆钉 
subgrade - 路基
filter element - 滤过篇件 
bag filter - 滤袋式滤清器袋式滤器 
cake - 滤饼
tape recorder - 录音机 
stove heating - 炉子供暖 
grate area - 炉箧积 
burden - 炉料
charge - 炉料
high sea【海洋】 - 狂浪
histogram - 频率分布图
frequency domain - 频率范围 
floatability - 漂浮性
deflection control - 偏转控制 
surface grinding - 平面磨削平面研磨 
plane symmetry - 平面对称 
plane wave expansion - 平面波展开 
plane wave - 平面波 
flat surface - 平面 
average diameter - 平均直径 
mean range - 平均射程 
average power - 平均功率 
average load - 平均负载 
average - 平均;平均的
smooth flow - 平滑怜 
smoothing - 平滑化
hatching - 剖面线
disintegrator - 破碎机
shattering - 破碎
cracking - 破裂
breaker - 破浪
peltier effect - 珀尔帖效应 
shield - 屏蔽
straightness - 平直度
leveler - 平整机
translation motion - 平移运动 
parallel displacement - 平行位移 
state of equilibrium - 平衡状态 
balance pressure - 平衡压力 
floating crane - 起重船 
initial position - 起始位置 
foaming - 起泡
landing skids - 起落橇 
take off - 起飞 
tightness test - 气密性试验 
air tightness - 气密性 
flow of gas - 气流 
air transport - 气力输送 
difform - 奇形的
desired value - 期待值 
spectral density - 谱密度 
spectral distribution - 谱分布 
universal - 普适的
drum boiler - 汽包锅炉 
gas oil - 气油 
pore - 气孔
welding torch - 气焊枪 
air pipe - 气管 
cylinder head - 气缸盖 
air valve - 气阀 
economic behaviour【经】 - 经济行为
economic depression【经】 - 经济萧条
dresser【机】 - 砂轮修整装置
dorsalis【动】 - 背侧动脉
dome【航】 - 航行舱
carcinogen【肿瘤】 - 致癌剂
carcinogenic effect【肿瘤】 - 致癌效应
carcass quality【畜牧】 - 胴体品质
buttocks【船】 - 船艄凸面
dry cleaning【矿】 - 干法选煤
drilling【矿】 - 打眼
dolly【矿】 - 提升绞车平衡重
dominant【数】 - 支配的
disturbed【气象】 - 扰动的
director【军】 - 指挥仪
discharge capacity【环境】 - 排污量
directional derivative【数】 - 方向导数
diesel oil【油气】 - 柴油
high sea【海洋】 - 狂浪
head【车辆】 - 汽车顶
globular protein【生化】 - 球状蛋白质
inlet velocity【航】 - 进口速度
indirect proof【数】 - 间接证明
horsehead【矿】 - 超前纵梁
transmission【机】 - 传动（设备）
cut【矿】 - 横切矿脉
thou【计量】 - 千分之一英寸
surplus【数】 - 剩余的
hematite【宝】 - 赤血石
hemosiderin【生化】 - 血铁黄素
hemagglutinin【生化】 免疫 - 血细胞凝集素
guard post【建】 - 护柱
closed subset【数】 - 闭子集
chasing【机】 - 车螺丝
chain code【数】 - 链式码
chain conveyor【机】 - 链式传送机
preparation【动】 - 动物体标本
predecessor【数】 - 前驱站
power function【数】 - 幂函数
written approval【法】 - 书面批准
tactics【军】 - 战术
abduct【法】 - 诱拐
anchor【建】 - 锚定装置
allowable stress【力】 - 许用应力
Acris【动】 - 蝗蛙属
moder【土壤】 - 半腐殖质
mid-range【数】 - 中列数
key link【经】 - 主要环节
dog days【气候】 - 伏天
catalytic hydrogenation【油气】 - 催化氢化
reinforced concrete column【建】 - 钢筋混凝土柱
launch pad【航】 - 发射坪
lateral acceleration【航】 - 横侧加速度
moat【建】 - 护城河
mirror turning【机】 - 镜面车削
milling【机】 - 铣削
metrical information【计量】 - 计量信息
mesothelial cell【细胞】 - 间皮细胞
funnel【动】 - 漏斗状物
fuel additive【油气】 - 油料添加剂
meteorological balloon【气象】;weather balloon【气象】 - 气象气球
limber【军】 - 前车
lift control【航】 - 升力控制
tapping screw【机】 - 自攻螺钉
phase angle of meshing【机】 - 囓合相位角
pedon【土壤】 - 单个土体
performance guarantee【法】 - 履行合同保证人
peak error【工经】 - 峰值误差
penguin【航】 - 地面训练机
pea【矿】 - 小粒黄铁矿
parking【交】 - 存车场
army base【军】 - 陆军基地
antioxidant【助剂】 - 阻氧化剂
furnishing【建】 - 室内陈设
secondary salinization【土壤】 - 次生盐化（作用）
face【木】 - 宽材面
hydrodynamic lubrication【机】 - 流体动力润滑
upper class【数】 - 上类
underground【矿】 - 井下
triplet【妇产】 - 三胞胎
hydraulic accumulator【机】 - 油压蓄能器
hydraulic coupler【机】 - 液力耦合器
hydraulic excavator【机】 - 液力挖掘机
splicing【生化】 - 剪接
owner【经】 - 所有者
Cambridge school【经】 - 剑桥学派
air support【航】 - 空中支持
air course【流】 - 空气流
aerodynamic【航】 - 空气动力学的
actin【生化】 - 肌动蛋白
acoustic emission【声】 - 声发射
accumulative【数】 - 累加的
antagonism【土壤】 - 拮抗现象
talking【矿】 - 岩层内部破裂声
morgue【医】 - 陈尸所
martingale【数】 - 鞅
lining【服装】 - 鞋里
block - 滑车
saddle - 滑板
slide - 滑板
resonator - 共振器共鸣器
resonance peak - 共振峰值 
resonance method - 共振法 
eutectic - 共晶体
conjugate - 共轭的
arch structure - 拱形结构 
arch dam - 拱坝 
arch - 拱
mercury column - 汞柱 
workpiece - 工件
technology - 工程学
engineering design - 工程设计 
factory automation - 工厂生产自动化 
fa - 工厂生产自动化
factory management - 工厂管理 
oil supply - 给油 
faucet - 给水栓
supply pipe - 给水管 
feed - 给水
proper velocity - 固有速度 
characteristic frequency - 固有频率 
natural frequency - 固有频率 
self power - 固有功率 
solidity - 固态
fixing device - 固定装置 
tapping machine - 攻丝机 
tapping - 攻螺丝;出铁
capacity - 功率
work function - 功函数 
L - 公升(Liter)
motor bus - 公共汽车 
nominal size - 公称尺寸 
hacksaw - 弓锯
working medium - 工组质 
operating point - 工足 
set screw - 固定螺丝 
fixed end - 固定端 
securing - 固定
crowning - 鼓度
valley floor - 谷底 
Antique - 古董枪
pinch - 箍缩
nave - 毂
solitary wave - 孤立波 
tectonic stress - 构造应力 
tubular - 管形的
tube bundle - 管束 
pipeline - 管路
piping system - 管道系统 
pipe fittings - 管道配件 
channel - 槽钢
tank - 槽
operation - 操作演算
manipulation - 操作控制
operating rules - 操祖程 
maneuverability - 操纵性
human operator - 操妆 
operating principle - 操篆理 
store house - 仓库 
residual deformation - 残余应变 
residue - 残余物
residual stress - 残余庞力 
residue - 残数
reference system - 参考系 
quarry - 采石场
material testing - 材料试验 
scoring - 擦伤
scuffing - 擦伤
Jag - 擦枪头
component - 部件
part - 部件
partial correlation - 部分相关 
walking robot - 步行机扑 
nonstop flight - 不着陆飞行 
stainless - 不锈的
incomplete expansion - 不完全膨胀 
watertight - 不透水的
impermeable stratum - 不透水层 
discontinuity - 不连续性
discontinuous - 不连续的
incompressible - 不可压缩的
impermeability - 不可透性
heterogeneity - 不均质
nonuniformity - 不均匀性
nonuniform flow - 不等速流 
invariable - 不变的
tab - 补翼
reinforcing plate - 补强板 
strengthening - 补强
refuelling - 补充注油
replenishment - 补充注油
lamina - 薄片
wafer - 薄片
membrane theory - 薄膜理论 
thin layer - 薄层 
skinner - 剥皮机
glass fiber reinforced plastic - 玻璃纤维增强塑料
glass cloth - 玻璃布 
boltzmann distribution - 玻耳兹曼分布 
wave resistance - 波阻 
air wave - 空气波 
caving - 空泡形成
space distribution - 空间分布 
xenobiotic metabolism【生化】 - 异生物质代谢
white cement【建】 - 白水泥
welding cable【机】 - 焊接缆线
weakness【经】 - 疲软
weathering【建】 - 泻水波
water hammer【矿】 - 水锤现象
violation【法】 - 犯法
verruca【昆】 - 毛瘤
valve【机】 - 滑盖开关
center height - 中心高度 
central point - 中心点 
central line - 中线 
quill - 中空轴
intermediate support - 中间支点 
mesosphere - 中间层
cultivator - 中耕除草机
medium pressure - 中等压力 
gravitational energy - 重力能 
gravity flow - 重力流 
gravity separation - 重力分离 
gravity anomaly - 重力反常 
gravimetry - 重力测量
gravity wave - 重力波 
gravity dam - 重力坝 
gravitational force - 重力 
force of gravity - 重力
repeated load - 重复载荷 
repeatability - 重复精度
planter - 种植器播种机
mass spectrometer - 质谱分析器 
barycenter - 质量中心
bearing clearance - 轴承间隙 
bearing load - 轴承荷载 
raceway grinding machine - 轴承滚道磨床
bearing load - 轴承负载 
environment temperature - 周围温度 
ambient air - 周围空气 
final state - 终态 
terminal velocity - 终速 
central control - 中央控制 
neutral plane - 中性面 
spindle - 主轴
main pipe - 主管道 
Bead - 珠状准星
pearlite - 珠光体
elbow joint - 肘接 
elbow - 肘管
boehmite【矿】 - 勃母石
ribosomal DNA【生化】 - （核糖）核蛋白体ＤＮＡ
finger【油气】 - 指梁
extraction【化工】 - 抽提
extreme point【数】 - 极值点
green【科技】 - 绿色（物）
glucoside【生化】 - 葡萄糖□
ganglioside【生化】 - 神经节□脂
front【建】 - 临街地
downhole       - 井底
dosage       - 加量
division       - 分类
dense       - 密实
cross-linking       - 交联
countermeasure       - 对策
corrode       - 溶蚀
blank       - 齿轮轮坯
blank       - 轮坯
biotoxicity       - 生物毒性
bay       - 海湾
backlash       - 侧隙
avoid       - 避免
anticlinal       - 背斜
ammonium       - 铵基
amino       - 胺基
algae       - 扁藻（浮游植物）
addendum       - 齿顶高
acceleration       - 加速度
irreversible       - 不可逆
involute       - 渐开线
integrate       - 积分
inordinately       - 不同程度
incubation       - 孵化速度
inclination       - 井斜
hydration       - 水解
hob       - 滚刀
hinge       - 铰链、枢纽
hematite       - 铁矿粉
gum       - 胶质
guar       - 瓜尔胶
glutenite       - 沙砾岩
generating       - 展成法
genera       - 大类
gear       - 齿轮机构
gasket       - 垫圈
forge       - 锻造
flush       - 冲蚀
flocculant       - 包被絮凝剂
flake       - 薄片
feasibility       - 可用性
solar house【建】 - 太阳室
solid foundation【建】 - 坚实基础
ceramic pump【化工】 - 陶瓷泵
androgen【生化】 - 雄激素
air valve【机】 - 风阀
miniature bearing - 微型轴承 
minicar - 微型小客车
micro motor - 微型电动机 
potential theory - 位势论 
potential - 位势
unknown - 未知的
incomplete fusion - 未焊透 
sanitary engineering - 卫生工程学 
stern tube - 尾轴管 
wake - 尾流伴流
tail rotor - 尾部螺旋桨 
tail - 尾部
pseudoplasticity - 伪塑性
pseudopotential - 伪势
maintainability - 维修保养方便性
maintenance - 维修
vickers hardness - 维氏硬度 
weibull distribution - 韦布尔分布 
discrete probability distribution【数】 - 离散概率分布
dining room【建】 - 饭厅
discrete element method【数】 - 离散元素法
discrete function【数】 - 离散函数
trichobothria【昆】 - 毛点
oil-producing country【油气】 工经 - 产油国
scarab【昆】 - 金龟子
logical function【数】 - 逻辑函数
evaluation【数】 - 计值
error ellipse【数】 - 误差椭圆
engagement【妇产】 - 衔接
coal rank【矿】 - 煤级
coal mine geology【矿】 - 煤矿地质学
crack tip【力】 - 裂纹尖端
counting system【经】 - 计数制
contributor【经】 - 资助国
contributory【法】 - 负连带偿还责任的人
carp【航】 - 轰炸瞄准具的制导附件
buck【矿】 - 试样研磨
hydrocracking【油气】 - 加氢裂化
brake lining【车辆】 - 闸衬片
bored pile【建】 - 钻孔桩
boiler pressure【动力】 - 锅炉蒸汽压力
homogenate【生化】 - 匀浆
batch【玻璃】 - 配合料
bay【建】 - 开间
backlash【机】 - 轮齿隙
axial load - 轴向负载 
axial - 轴向的
shoulder - 轴肩
s function - 轴功能 
clamshell - 抓斗
molding sand - 铸造用砂 
casting defect - 铸造缺陷 
casting alloy - 铸造合金 
foundry - 铸造车间;铸造
founding - 铸造
ladle - 铸桶
iron foundry - 铸铁车间 
standing wave - 驻波 
cistern - 贮液器
reservoir - 贮水槽
gas holder - 贮气罐 
oil hole - 注油孔 
injection molding machine - 注入成型机
transition - 转移
steering column - 转向柱 
king pin - 转向梢 
knuckle - 转向节
steering angle - 转向角 
bogie - 转向架
tie rod - 转向横拉杆 
steering - 转向
turn - 转向
tachometer - 转速计
torque wrench - 转矩扳手 
torque - 转矩
center of rotation - 转动中心
sprue - 注道
helper - 助手
heading - 追
impact - 撞击冲击
ram - 撞凰
phase diagram - 状态图 
state feedback control - 状态反馈控制
state variable - 状态参数 
regime - 状态
Load - 装药剂量
charge - 装药
palletizer - 装托盘机
rotating - 转动的
transition state - 转变状态 
transition region - 转变区 
effort - 酌力
application point - 酌点 
action - 酌
turbidity current - 浊流 
delay time - 延迟时间 
time lag - 延迟 
fume - 烟雾
flue gas - 烟气 
carbon black - 烟黑 
hydraulic lift - 液压升降机 
hydropneumatic - 液压气动的
hydraulic torque converter - 液压扭矩变换器
remote - 遥远的
rocker arm - 摇杆 
shaking - 摇荡
rocking - 摇摆
anodic dissolution - 阳极溶解 
uplift - 扬压
chord - 翼弦
hydraulic hammer - 液压锤 
diaphragm【化工】 - （分隔溶液的）膜片
steam pressure - 蒸汽压 
vapor phase - 蒸汽相 
steam temperature control - 蒸汽温度控制
supporting point - 支承点 
support - 支撑
steam trap - 蒸汽回水阀 
steam heating - 蒸汽采暖 
vapor - 蒸汽
vaporimeter - 蒸气压力表
evaporation heat - 蒸发热 
main engine - 症动机 
positive pressure - 正压力 
sinusoid - 正弦曲线
sinusoidal wave - 正弦波 
direct impact - 正碰 
facade - 正面
normal section - 正截面 
sign change - 正负变换 
proper rate - 正常速率 
normal wear - 正常磨损 
normal mode - 正常模式 
sprue - 直浇口
orthogonal - 直交的
direct shear test - 直剪试验
spur bevel gear - 直齿伞齿轮
spur gear - 直齿轮 
main drive - 肢动 
driving wheel - 织轮 
acting force - 织力 
knowledge engineering - 知识工程 
principal load - 知荷载 
battle ship - 枝舰 
cowling - 整林
rim - 轮缘
pulse height - 脉冲高度 
fall - 落差
head - 落差
helix - 螺旋线
spiral staircase - 螺旋梯 
propeller blade - 螺旋桨叶 
prop - 螺旋桨
spinner - 螺旋毂盖
coiled spring - 螺旋弹簧 
pulse generator - 脉冲发生器脉冲振荡器 
Magnum - 麦格农
mach line - 马赫线 
dolly - 铆钉撑锤
rivet - 铆钉;铆接
blank - 毛坯
slug flow - 慢流 
full load operation - 满载运行 
high tide - 满潮 
pulse jet - 脉动式喷气发动机 
pulsed flow - 脉动流 
pulsation - 脉动
pulsing - 脉动
power spectrum - 密度谱 
density measurement - 密度测定 
metre - 米
monte carlo method - 蒙特 卡罗法
magnesium alloy - 镁合金 
hourly output - 每小时产量 
impulse response - 脉冲响应 
phase - 脉冲相位
pulse energy - 脉冲能量 
friction pendulum - 摩擦摆 
film boiling - 膜层沸腾 
film - 膜;胶片
shoe - 模座之上下模板
model test - 模型试验 
modelling - 模型化
model maker - 模型工 
modal analysis - 模态分析 
modal superposition - 模态叠加 
soot - 煤烟
gas pressure - 煤气压力 
gas plant - 煤气发生装置 
gas generator - 煤气发生炉 
gas engine - 煤气发动机 
coal burning boiler - 煤锅炉 
pulverized coal fired boiler - 煤粉锅炉
riser - 冒口
riveting - 铆接
disturbance - 扰动
fuel gauge - 燃油面指示器 
combustion pressure - 燃烧压力 
burning rate - 燃烧速度 
burning zone - 燃烧带 
combustion instability - 燃烧不稳定性 
burn - 燃烧
turbine helicopter - 燃气涡轮直升机 
fuel tank - 燃料箱 
fuel injection - 燃料喷射 
fuel feed - 燃料供给 
fuel line - 燃料导管 
flaw - 缺陷
ball valve - 球形阀 
pellet - 球团矿
thermal engineering - 热工学 
hip - 热等静压
heat absorption - 热的吸收 
heat conductivity - 热导率 
total pressure - 全压 
holography - 全息摄影
through thickness - 全厚度 
full power - 全功率 
thermistor - 热敏电阻
heat flux - 热流 
thermal cracking - 热裂解 
calorimetry - 热量测定法
thermomechanical effect - 热力学效应 
heat conductivity - 热传导系数 
hot forming - 热成形 
thermal wave - 热波 
pivoting - 绕轴旋转
spoiler - 绕菱
spoiler - 扰连
perturbation matrix - 扰动矩阵 
perturbation method - 扰动法 
imitation leather - 人造皮革 
artificial vision - 人工视觉 
thermodynamic - 热力学的
theory of heat - 热理论 
heat exchanger - 热交换器换热器 
heat recovery - 热回收 
thermal inertia - 热惯性 
visual inspection - 肉眼检查 
man made - 人工的 
artificial - 人工的
human error - 人差 
thermal resistance - 热阻 
heat and mass transfer - 热质量转移
heat index - 热指数 
gilding - 镀金
buster - 堵口
loading - 堵
independence - 独立
reader - 读出装置
freezer - 冻结装置
freezing method - 冻结方法 
freezing method - 冻结法 
dynamic pressure - 动压力 
dynamic behavior - 动态行为 
dynamic error - 动态误差 
dynamic stability - 动态稳定性 
wad【军】 - 炮塞
quartile【数】 - 四分位数
pump【机】 - 唧筒
stabilizer【航】 - 安定面
spreader【化工】 - 涂布器
splined shaft【机】 - 多键轴
solar house【建】 - 太阳室
solid foundation【建】 - 坚实基础
ceramic pump【化工】 - 陶瓷泵
androgen【生化】 - 雄激素
air valve【机】 - 风阀
miniature bearing - 微型轴承 
minicar - 微型小客车
micro motor - 微型电动机 
potential theory - 位势论 
potential - 位势
unknown - 未知的
incomplete fusion - 未焊透 
sanitary engineering - 卫生工程学 
stern tube - 尾轴管 
wake - 尾流伴流
tail rotor - 尾部螺旋桨 
tail - 尾部
pseudoplasticity - 伪塑性
pseudopotential - 伪势
maintainability - 维修保养方便性
maintenance - 维修
vickers hardness - 维氏硬度 
weibull distribution - 韦布尔分布 
discrete probability distribution【数】 - 离散概率分布
dining room【建】 - 饭厅
discrete element method【数】 - 离散元素法
discrete function【数】 - 离散函数
trichobothria【昆】 - 毛点
oil-producing country【油气】 工经 - 产油国
scarab【昆】 - 金龟子
logical function【数】 - 逻辑函数
hydraulic test - 水压试验 
property - 性质
performance index - 性能指标 
performance characteristic - 性能特性曲线 
performance - 性能
core making - 型芯制造 
stem - 型管电极电解加工
shape mill - 型钢轧机 
form factor - 形状系数 
form - 形状
bird【鸟】 - 鸟
consideration【法】 - 对价
top【海洋】 - 洋面
pneumatic tube【机】 - 气胎
piston stroke【机】 车辆 - 汽缸□□行程
fillet【建】;insertion strip【公路】;panel【服装】 - 嵌条
fetal death【妇产】 - 死胎
feather【机】 - 滑键
explosive【化工】 - 炸药
environmental law【法】 - 环境法
environmental risk assessment【环境】 - 环境危险评价
environmental contamination【环境】 - 环境沾污
environmental exposure【环境】 - 环境暴露
environment factor【环境】 - 环境因子
engine room【动力】 - 发动机房
efflorescence【建】 - 渗斑
economizer【机】 - 省煤器
drizzle【气象】 - 毛毛雨
drying machine【化工】 - 烘燥机
glazing bead【建】 - 镶玻璃条
genotype distribution【环境】 - 遗传型分布
pilaster【建】 - 半露柱
paria【昆】 - 内唇侧区
camera【法】 - 审判员密议室
business industry【工经】 - 商办工业
Braconidae【昆】 - 小茧蜂科
bogie【机】 - 台床
basic plan【经】 - 基本方案
basic frame【机】 - 基架
basal cell【昆】 - 基室
banquette【建】 - 台坎
termination【妇产】 - 终止妊娠
mechanical stability【机】 - 机械稳定性
mechanical error【机】 - 机械上的错误
mechanical wave【力】 - 机械波
mechanical impedance【力】 - 机械阻抗
mechanical analysis【力】 - 机械分析
machine part【机】 - 机器零件
liquidator【法】 - 财产清算人
inverse regression【数】 - 逆回归
corporate body【法】 - 法人团体
Butt - 后托、枪托同“后托”(buttstock)。
back view - 后视图 
rear drive - 后轮传动 
restoring force - 回复力 
recovery - 回复
resilience - 回弹能
back substitution - 回代 
chb - 化学切料
traveller - 滑柱
slip line - 滑移线 
glide - 滑移
taxiing - 滑行
slip ring - 滑环 
sliding resistance - 滑动阻力 
slip resistance - 滑动阻力 
sliding door - 滑动门 
slip ratio - 滑动比 
slide - 滑动
repercussion - 回冲击反撞
back stroke - 回程 
brightness - 辉度
luminance - 辉度
volatile component - 挥发分 
gray body - 灰色体 
spring coil - 簧圈 
reduced pressure - 换算压力 
shift - 换班
buffer - 缓冲器减震器
shock absorber - 缓冲器缓冲装置 
damper spring - 缓冲弹簧 
Baffle - 缓冲板
Epoxy - 环氧树脂
annular space - 环形间隙 
ring bolt - 环首螺栓 
mixing length - 混合长度 
plotter - 绘图仪
plotting - 绘图
rotary motion - 回转运动 
gyro - 回转仪
slewing mechanism - 回转机构 
slewing gear - 回转机构 
revolution - 回转
recycling - 回用
cyclotron resonance - 回旋加速撇振 
return pin - 回位梢 
backwater - 回水
annular flow - 环流 
rocketry - 火箭学
rocketry - 火箭技术
type - 活字
harrier【鸟】 - 鹞
ring width【机】 - 套圈宽度
hammering【机】 - （金属表面的）锤印
hand【脊椎】 - （猿猴的）脚
electric starter【车辆】 - 电启动器
air purification - 空气净化 
air cleaning - 空气净化 
air conditioner - 空气第器 
air hammer - 空气锤 
air wave - 空气波 
caving - 空泡形成
space distribution - 空间分布 
xenobiotic metabolism【生化】 - 异生物质代谢
white cement【建】 - 白水泥
welding cable【机】 - 焊接缆线
weakness【经】 - 疲软
weathering【建】 - 泻水波
water hammer【矿】 - 水锤现象
violation【法】 - 犯法
verruca【昆】 - 毛瘤
valve【机】 - 滑盖开关
center height - 中心高度 
central point - 中心点 
central line - 中线 
quill - 中空轴
intermediate support - 中间支点 
mesosphere - 中间层
cultivator - 中耕除草机
medium pressure - 中等压力 
gravitational energy - 重力能 
gravity flow - 重力流 
gravity separation - 重力分离 
gravity anomaly - 重力反常 
gravimetry - 重力测量
gravity wave - 重力波 
gravity dam - 重力坝 
gravitational force - 重力 
force of gravity - 重力
repeated load - 重复载荷 
repeatability - 重复精度
planter - 种植器播种机
mass spectrometer - 质谱分析器 
barycenter - 质量中心
bearing clearance - 轴承间隙 
bearing load - 轴承荷载 
raceway grinding machine - 轴承滚道磨床
bearing load - 轴承负载 
environment temperature - 周围温度 
ambient air - 周围空气 
final state - 终态 
frequency analyzer - 频率分析器 
histogram - 频率分布图
frequency domain - 频率范围 
floatability - 漂浮性
deflection control - 偏转控制 
surface grinding - 平面磨削平面研磨 
plane symmetry - 平面对称 
plane wave expansion - 平面波展开 
plane wave - 平面波 
flat surface - 平面 
average diameter - 平均直径 
mean range - 平均射程 
average power - 平均功率 
average load - 平均负载 
average - 平均;平均的
smooth flow - 平滑怜 
smoothing - 平滑化
hatching - 剖面线
disintegrator - 破碎机
shattering - 破碎
cracking - 破裂
breaker - 破浪
peltier effect - 珀尔帖效应 
shield - 屏蔽
straightness - 平直度
leveler - 平整机
translation motion - 平移运动 
parallel displacement - 平行位移 
state of equilibrium - 平衡状态 
balance pressure - 平衡压力 
floating crane - 起重船 
initial position - 起始位置 
foaming - 起泡
landing skids - 起落橇 
take off - 起飞 
tightness test - 气密性试验 
air tightness - 气密性 
flow of gas - 气流 
air transport - 气力输送 
difform - 奇形的
desired value - 期待值 
spectral density - 谱密度 
spectral distribution - 谱分布 
universal - 普适的
drum boiler - 汽包锅炉 
gas oil - 气油 
pore - 气孔
welding torch - 气焊枪 
air pipe - 气管 
cylinder head - 气缸盖 
shift       - 偏移
self-locking       - 自锁
seal       - 堵塞
screw       - 螺杆
roller       - 滚子
rocker       - 摇杆
robotics       - 机器人学
rise       - 推程
reversible       - 可逆
resistance       - 阻抗力
repulsion       - 斥力
remediation       - 补救
pawl       - 棘爪
Nomogram       - 诺模图
negative       - 负
module       - 模数
modification       - 改性
model       - 模式(型)
mill       - 磨铣
mesh       - 目
membership       - 隶属度
mechanism       - 机构
matching       - 拼接
manipulator       - 机器人操作器
macroscopic       - 宏观
machinery       - 机械
log       - 录井
link       - 构件
manufacturing process - 生产过程 
process of production - 生产过程 
production technology - 生产工程学 
production costs - 生产费 
boost - 升压
lifting moment - 升力矩 
lift - 升降机
elevator - 升降舵
masonry drill【建】 - 圬工钻
macroeconometric model【经】 - 宏观经济计量模型
line【农】 - 品系（育种）
lid【气象】 - 大气温度逆增
lead time【交】 - 商品在途时间
sewerage - 下水道
lower critical - 下临界的 
lower bound - 下界 
inlet line - 吸入管路 
malfunction - 误动作
error compensation - 误差补偿 
material transfer - 物质转移 
material balance - 物质平衡 
body - 物体
ether       - 醚基
envelop       - 包被
copolymerization       - 共聚
concentration       - 浓缩
compressibility       - 可压缩性
compatibility       - 配伍性
combine       - 复合
clockwise       - 顺时针
clearance       - 间隙
clearance       - 径向间隙
clean       - 冲洗
chlorite       - 海绿石
chassis       - 底座
chamfer       - 倒角
centralization       - 居中
census       - 调查
carbon       - 碳质
bulkhead       - 堵塞物
borehole       - 井壁稳定
tension       - 张紧力
system       - 体系
swell       - 膨胀
subside       - 沉降
subroutine       - 子程序
studs       - 双头螺柱
spindle       - 心轴
spectrophotometer       - 分光度法
slipping       - 打滑
slider       - 滑块
simultaneously       - 同时
silicone       - 硅
shift       - 偏移
self-locking       - 自锁
seal       - 堵塞
screw       - 螺杆
roller       - 滚子
rocker       - 摇杆
robotics       - 机器人学
rise       - 推程
reversible       - 可逆
resistance       - 阻抗力
repulsion       - 斥力
remediation       - 补救
pawl       - 棘爪
Nomogram       - 诺模图
negative       - 负
module       - 模数
modification       - 改性
model       - 模式(型)
mill       - 磨铣
stiffness matrix - 刚度矩阵 
rigidity - 刚度
stiffness - 刚度
EA - 个,只(计量单位)(Each)
soundproof material - 隔音材料 
spacer - 隔离片
bulkhead - 隔壁
anisotropic - 蛤异性的
isotropism - 蛤同性
header - 割穗机;顶锻机;集管
cutting torch - 割炬 
high voltage - 高压 
high efficiency - 高效率 
high speed wind tunnel - 高速风洞
high speed - 高速的 
high speed - 高速 
working characteristic - 工棕性曲线 
working load - 工棕荷 
i iron - 工字钢 
hydraulic oil - 工淄 
working temperature - 工茁度 
shop drawing - 工准 
working fluid - 工缀体 
working pressure - 工坠力 
operating time - 工妆间 
bench - 工专
table - 工专
working stress - 工爪力 
process controller - 工艺过程控制装置 
industrial boiler - 工业用锅炉 
industrial standard - 工业标准 
motion study - 工时标定 
tool breakage - 工具破损 
sharpener - 工具磨床;刃磨工
jolting - 震压造型
oscillator - 振子
shaking out - 振摇萃取 
singing - 振鸣
vibrational state - 振动状态 
vibration amplitude - 振动振幅 
island chain【海洋】 - 岛链
interior decorator【建】 - 室内装饰工
adapter【机】 - 附加件
rag【建】 - 石板瓦
Embarrassed - 囧
rudimentary【昆】 - 未发育的
roof light【建】 - 采光天窗
precast concrete【建】 - 预制混凝土构件
prestressed concrete【建】 - 预应力混凝土
almost all【数】 - 几乎所有
microhardness - 显微硬度
microscopic test - 显微镜检验 
sensible heat - 显热 
chord - 弦
analogue method - 相似法 
similar - 相似的
coupled vibration - 相关振动 
relative flow - 相对怜 
relative height - 相对高度 
lower limit - 下限尺寸 
sag - 下弯
silencer - 消声器
fire extinguisher - 消火器灭火器 
consumption - 消耗量
rate of consumption - 消耗定额
consumption rate - 消耗比 
extinction - 消光
matt - 消光
rubber bearing - 橡胶轴承 
rubber band - 橡胶带 
speed of response - 响应速度 
response spectrum - 响应谱 
response analysis - 响应分析 
Click - 响
detailing - 详细设计
detail drawing - 详图 
part drawing - 详图 
phase transformation - 相变 
restrict - 限制
margin - 限界
inclined plane - 斜面 
shoot - 斜沟
slope - 斜度
helical gear - 斜齿轮 
chute - 斜槽
pointing - 镶
box - 箱子
phase shift - 相移 
dependence - 相依性
phase noise - 相位噪声 
phase difference - 相位差 
deformation - 形变
running gear - 行走装置 
efficiency curve - 效率曲线 
billet - 小钢坯
UR - 小便斗(Urinal)
pin - 销钉
key - 销;键
vanishing - 消失
trimmer - 修整器蝶器
pressure turbine - 反动轮机 
dumper - 翻斗机
tipper - 翻斗机
mast - 帆柱
rating torque - 额定扭矩 
rated output - 额定功率 
rated load - 额定负载 
rated load - 额定负荷 
rest - 防震台
stay - 防震台
rust protection - 防锈 
rust prevention - 防锈 
anticorrosive paint - 防蚀涂料 
goggles - 防护眼镜
HA - 防护区(Hazard)
rust preventive - 防腐蚀剂 
Dust cover - 防尘盖 
flameproof equipment - 防爆设备 
explosion proof - 防爆的 
direction cosine - 方向余弦 
direction angle - 方向角 
sense - 方向
normal component - 法向分量 
normal - 法线
weight - 法码
flange gasket - 法兰垫片 
valve body - 阀体 
valve - 阀,闸门
discovery - 发现
flight performance - 飞行特性 
flight simulator - 飞行模拟机 
flight path - 飞行路径 
bearing - 方位;轴承
van der waals force - 范德瓦耳斯力
counteraction - 反酌
reversing - 反转
reactor vessel - 反应堆容器 
reaction pressure - 反压 
backpressure - 反向压力;反压力
nonlinear system - 非线性系 
aircraft engine - 飞机发动机 
aerodrome - 飞机场
plane - 飞机
gutter - 放水沟
radiator - 放热器散热器
vent - 放气孔
purging - 放气
power gain - 放大系数 
intensifier - 放大器倍增器
enlargement scale - 放大标度 
harmonic - 谐波
ship repair - 修船 
property - 性质
performance index - 性能指标 
performance characteristic - 性能特性曲线 
performance - 性能
core making - 型芯制造 
stem - 型管电极电解加工
shape mill - 型钢轧机 
form factor - 形状系数 
form - 形状
bird【鸟】 - 鸟
consideration【法】 - 对价
top【海洋】 - 洋面
pneumatic tube【机】 - 气胎
piston stroke【机】 车辆 - 汽缸□□行程
fillet【建】;insertion strip【公路】;panel【服装】 - 嵌条
fetal death【妇产】 - 死胎
feather【机】 - 滑键
explosive【化工】 - 炸药
environmental law【法】 - 环境法
environmental risk assessment【环境】 - 环境危险评价
environmental contamination【环境】 - 环境沾污
environmental exposure【环境】 - 环境暴露
environment factor【环境】 - 环境因子
engine room【动力】 - 发动机房
efflorescence【建】 - 渗斑
economizer【机】 - 省煤器
drizzle【气象】 - 毛毛雨
drying machine【化工】 - 烘燥机
glazing bead【建】 - 镶玻璃条
genotype distribution【环境】 - 遗传型分布
pilaster【建】 - 半露柱
paria【昆】 - 内唇侧区
owner【经】 - 所有者
Cambridge school【经】 - 剑桥学派
air support【航】 - 空中支持
air course【流】 - 空气流
aerodynamic【航】 - 空气动力学的
actin【生化】 - 肌动蛋白
acoustic emission【声】 - 声发射
accumulative【数】 - 累加的
antagonism【土壤】 - 拮抗现象
talking【矿】 - 岩层内部破裂声
morgue【医】 - 陈尸所
martingale【数】 - 鞅
lining【服装】 - 鞋里
block - 滑车
saddle - 滑板
slide - 滑板
wave energy - 波能 
wave crest - 波峰 
wave theory - 波动论 
wave mechanics - 波动力学 
wave propagation - 波的传播 
wave packet - 波包 
parallel running - 并联运行 
parallel operation - 并联运行 
parallel connection - 并联 
handle - 柄
shank - 柄
bingham model - 宾汉模型 
surface quality - 表面质量 
skin effect - 表面效应 
surface displacement - 表面位移 
surface velocity - 表面速度 
surface defect - 表面缺陷 
profilometer - 表面光洁度仪
surface rigidity - 表面刚性 
surface roughness - 表面粗度 
normal pressure - 标准压力 
standard - 标准器
standard measure - 标准衡器 
norm - 标准
title block - 标题栏 
marking - 标示
scalar field - 标量场 
scale length - 标尺长度 
scoop - 杓子
variable mass - 变质量 
gearbox - 变速箱
transmission - 变速箱
control lever - 变速杆 
current transformer - 变流 
transformation theory - 变换论 
variational problem - 变分问题 
fluctuation - 变动
substation - 变电所
shallow shell - 扁壳 
slab - 扁钢坯扁钢锭
braiding machine - 编组机 
braided wire - 编织线 
edge stress - 边缘应力 
edge crack - 边缘裂缝 
borderline - 边线
slope failure - 边坡破坏 
boundary value - 边界值 
bem - 边界元法
boundary conditions - 边界条件 
boundary - 边界
Embarrassed - 囧
ultrafilter【化工】 - 超滤器
transportation equipment【交】 - 运输设备
toilet【建】 - 卫生间
tilbury【车辆】 - 轻便两轮马车
industrial noise【环境】 - 工业噪声
industrial age【工经】 - 工业时代
industrial complex【工经】 - 工业联合企业
tuba【气象】 - 管状云
land【化工】 - 溢料面
lake【地理】 - 湖
issue【会计】 - 发行额
infinite【数】 - 无限
number of run【交】 - 班次
normal rate【交】 - 正常运价
deck line【船】 - 甲板线
theoretical value - 理论值 
mile - 哩
odometer - 里程计
plowshare - 犁铧
ionic liquid - 离子液体 
ion impact - 离子碰撞 
ion diffusion - 离子扩散 
cube - 立方体
mechanical system - 力学系 
mechanical energy - 力学能 
mechanics - 力学
ion etching - 离子刻蚀 
ie - 离子刻蚀
ion trajectory - 离子轨道 
ion plating - 离子镀敷 
centrifugal separator - 离心分离机 
discrete element method - 离散单元法 
continuous system - 连续系统 
continuous random variable - 连续随机变量 
continuous flow - 连续怜 
force density - 力密度 
force sensor - 力传感器 
force field - 力场 
chain conveyor - 链式运输器 
continuous medium - 连续介质 
continuous process - 连续工程 
continuity equation - 连续方程 
continuous wave - 连续波 
chain reaction - 连锁反应 
connecting rod - 连结棒 
connection - 连结
tie - 连接杆
joint - 连接
juncture - 连接
gasifier - 气体发生器
gaseous - 气体的
gas nitriding - 气体氮化 
gas explosion - 气体爆炸 
cylinder - 气瓶
migration length - 迁移长度 
motor boat - 汽艇 
carry over - 汽水共腾 
atmometer - 汽化计
evaporimeter - 汽化计
cylinder sleeve - 汽缸套 
steamer - 汽船
steamship - 汽船
automotive fuel - 汽车燃料 
latent energy - 潜能 
slat - 前缘缝翼
leading edge - 前缘 
front wing - 前翼 
toe in - 前束 
Foresight - 前瞄准具
camber - 前轮外倾角
Forearm - 前护木
patenting - 铅处理
garage - 汽车库;汽车维修厂
automotive industry - 汽车工业 
automobile plant - 汽车工厂 
automotive engine - 汽车发动机 
motor vehicle - 汽车 
bridge circuit - 桥接电路 
strong earthquake - 强震 
strong shock - 强激波 
reinforced plastics - 强化塑料 
strong wind - 强风 
strength test - 强度试验 
strength calculation - 强度计算 
intensity wave - 强度波 
Gun control - 枪械管制 
Firearm - 枪械
pulling force - 牵引力 
tractive force - 牵引力 
edge tool - 切悉具 
chopper - 切碎机
Bolt - 枪栓
Jump - 枪口上扬
Gunsmith - 枪匠
Accelerator - 枪机加速器
Battery - 枪机待发
Action - 枪机
Lock - 枪机
Barrel - 枪管
allowable load - 容许负荷 
permissible - 容许的
capacity test - 容量试验 
volumetric efficiency - 容积效率;充填系数 
insolation - 日光浴
schedule - 日程
routine maintenance - 日常维修 
ductile fracture - 韧性断裂 
lubricant additive - 润滑剂的添加剂 
rayleigh wave - 瑞利波 
softness - 软性
cord - 软线
soldering - 软钎焊
floppy disk - 软磁盘 
incidence angle - 入射角 
incident angle - 入射角 
in field - 入射场 
incoming wave - 入射波 
entering - 入射
inlet temperature - 入口温度 
creep damage - 蠕变损伤 
scattering intensity - 散射强度 
ferric oxide - 三氧化二铁 
tee - 三通管
tripod - 三脚
delta connection - 三角形接线 
creep test - 蠕变试验 
creep rupture - 蠕变断裂 
trigonometric series - 三角级数 
cardo【昆】 - 阳（茎）基环
bone meal【畜牧】 - 骨粉
boundary layer【流】 - 附面层
reinforcement【建】 - 加筋
reattachment【流】 - 再附着
reconnaissance troops【军】 - 侦察部队
quadratic approximation【数】 - 二次逼近
collocation method【数】 - 配置方式
stress-strain【力】 - 应力应变
stock【木】 - 木工刨
stockade【建】 - 木栏
stockpile【矿】 - 料堆
petroleum distillate【油气】 - 石油馏分
petroleum refining【油气】 - 石油炼制
pencil【林】 - 美国圆柏
coefficient【数】 - 系数
choline【生化】 - 胆碱
chorionic gonadotropin【生化】 - 绒毛膜促进腺激素
chlorogenic acid【生化】 - 绿原酸
diaphorase【生化】 - 硫辛□胺脱氢□
detailing【建】 - 细部设计
malfunction - 误动作
error compensation - 误差补偿 
material transfer - 物质转移 
material balance - 物质平衡 
body - 物体
state equation - 物态方程 
pvd - 物理气相沉积
physical simulation - 物理模拟 
pcm - 物理化学加工
linear vibration - 线性振动 
rate of descent - 下降速度 
letdown - 下降
glide path - 下滑航迹 
bottom plate - 下固定板 
sag - 下垂
lower surface - 下表面 
refinement - 细微
fine crushing - 细碎 
necking - 细颈现象
smooth cut - 细锉纹 
slenderness ratio - 细长比 
slenderness - 细长比
system identification - 系统识别 
anchoring - 系泊
system - 系
hobbing - 铣刀
milling - 铣
LAV - 洗脸盆(Lavatory)
linear mapping - 线性映射 
linear elasticity - 线性弹性 
diagram - 线图
line voltage - 线电压 
modern control theory - 现代控制理论 
field test - 现场试验 
microstructure - 显微组织
microhardness - 显微硬度
microscopic test - 显微镜检验 
sensible heat - 显热 
chord - 弦
analogue method - 相似法 
similar - 相似的
coupled vibration - 相关振动 
relative flow - 相对怜 
relative height - 相对高度 
lower limit - 下限尺寸 
sag - 下弯
silencer - 消声器
fire extinguisher - 消火器灭火器 
consumption - 消耗量
rate of consumption - 消耗定额
ram - 撞凰
phase diagram - 状态图 
state feedback control - 状态反馈控制
state variable - 状态参数 
regime - 状态
Load - 装药剂量
charge - 装药
palletizer - 装托盘机
rotating - 转动的
transition state - 转变状态 
transition region - 转变区 
effort - 酌力
application point - 酌点 
action - 酌
turbidity current - 浊流 
degree of accuracy - 准确度
assembly drawing - 装配图 
assembly process - 装配过程 
assembly technology - 装配工艺 
erector - 装配工
assembly plant - 装配厂 
armored cable - 装甲缆 
armor plate - 装甲板 
Loading port - 装弹口 
equip - 装备
pile foundation - 桩基础 
pile - 桩
rotameter - 转子量计
rotator - 转子
transposed matrix - 转置矩阵 
power feed - 自动进给 
automatic checking - 自动检验 
recorder - 自动记录器
g function - 准备功能 
coning - 锥旋
conical surface - 锥面 
taper angle - 锥角 
taper turning - 锥度切削车圆锥 
atc - 自动换刀装置
automatic welding machine - 自动焊机
automatic spot welding - 自动点焊
automatic pilot - 自动导航装置 
atr - 自动带读出器
automated warehouse - 自动仓库 
automatic warehouse - 自动仓库 
subdomain - 子区域
subregion - 子区域
attitude control - 姿态控制 
ignition temperature - 着火温度 
action principle - 酌原理 
recurrence rate - 复现率 
complex impedance - 复数阻抗 
complex mode - 复模态 
complex stress - 复合应力 
Laminated - 复合夹板
com - 复合加工
cow - 复合加工
float valve - 浮球阀 
buoyancy force - 浮力 
scaffold - 浮架
slot - 缝
front - 锋面
peak value - 峰值 
induced current - 感应电流 
induction current - 感应电流 
sensing - 感觉
beam - 杆
girder - 杆
perch - 杆
pole - 杆
stake - 杆
composite wave - 复合波 
complex - 复合
adhesion coefficient - 附着系数 
adherence - 附着
adhesion - 附着
accessory - 附属品
additional pressure - 附加压力 
negative refraction - 负折射 
load capacity - 负载容量 
load - 负载
load curve - 负荷曲线 
carrying capacity - 负荷量 
negative resistance - 负电阻 
corrosive - 腐蚀剂
limousine - 高级轿车
high stability - 高度稳定的 
Elevation - 高低调整
high - 高的
dryer - 干燥器
trunk - 干线
interference fit - 干涉配合 
interferometry - 干涉法
dry friction - 干磨擦 
destructive distillation - 干馏 
dry air - 干空气 
lid - 盖
modification - 改良
improver - 改进剂
rich gas - 富气 
glutenite       - 沙砾岩
generating       - 展成法
genera       - 大类
gear       - 齿轮机构
gasket       - 垫圈
forge       - 锻造
flush       - 冲蚀
flocculant       - 包被絮凝剂
flake       - 薄片
feasibility       - 可用性
ether       - 醚基
envelop       - 包被
copolymerization       - 共聚
concentration       - 浓缩
compressibility       - 可压缩性
compatibility       - 配伍性
combine       - 复合
clockwise       - 顺时针
clearance       - 间隙
clearance       - 径向间隙
clean       - 冲洗
chlorite       - 海绿石
chassis       - 底座
chamfer       - 倒角
centralization       - 居中
census       - 调查
carbon       - 碳质
bulkhead       - 堵塞物
borehole       - 井壁稳定
tension       - 张紧力
system       - 体系
swell       - 膨胀
subside       - 沉降
subroutine       - 子程序
studs       - 双头螺柱
spindle       - 心轴
spectrophotometer       - 分光度法
slipping       - 打滑
slider       - 滑块
simultaneously       - 同时
silicone       - 硅
shift       - 偏移
self-locking       - 自锁
seal       - 堵塞
screw       - 螺杆
roller       - 滚子
rocker       - 摇杆
robotics       - 机器人学
rise       - 推程
reversible       - 可逆
brake lining - 刹车摩擦片 
dune buggy - 沙漠用越野汽车 
scavenging - 扫气
scanner - 扫描装置
installed capacity - 设备容量 
coil - 蛇管
burn through - 烧蚀 
ablation - 烧蚀
agglomeration - 烧结
cope - 上型框
Feed - 上膛
tdc - 上死点
top view - 上视图 
lifting work - 上升功 
lifting height - 上升高度 
lifting - 上升
rise - 上升
stable state - 稳定状态 
stationary state - 稳定状态 
stable system - 稳定系 
stable orbit - 稳定轨道 
steady - 稳定的
permanent wave - 稳定波 
turbulence - 紊乱
turbulent flow - 紊流湍流 
turbulent - 紊聊
increase of temperature - 温度上升 
THS - 温度开关(Thermostat)
thermograph - 温度记录机
temperature measurement - 温度测量 
position control - 位置控制 
positional control - 位置控制 
position sensor - 位置检测器位置传感器 
formation of eddy - 涡旋形成 
vortex - 涡旋
turbocharger - 涡轮增压器
turboprop aircraft - 涡轮螺旋桨飞机 
turboprop - 涡轮螺旋桨发动机
turbogenerator - 涡轮发电机
eddy - 涡流旋流
frictionless - 无摩擦的
blind flange - 无孔法兰盘 
nonporous - 无孔的
reactive power - 无功功率 
seamless tube - 无缝管 
jointless - 无缝的
seamless - 无缝的
vorticity - 涡量
weightlessness - 无重力
oil free compressor - 无油压缩机 
mud treatment      - 泥浆处理
planetary transmission      - 行星齿轮装置
well track      - 井眼轨迹
starting torque      - 启动力矩
output torque      - 输出力矩
refer to      - 结合
polymer drilling fluid     - 聚合物钻井液
lab and field     - 室内实验和现场
exploration and development     - 勘探与开发
radius of curvature     - 曲率半径
angle of contact     - 包角
thrust ball bearing     - 推力球轴承
synthesis of mechanism     - 机构综合
natural and synthetic     - 天然或人造
battening【建】 - 木板间壁
balance of rotor     - 转子平衡
nuclear magnetic resonance     - 核磁共振（NMR）
number of threads     - 蜗杆头数
gnat【昆】 - （叮人的有翅）小昆虫
furniture【建】 - （门上的）附件装置
flight plan【航】 - 飞行计划
festooned【昆】 - 饰彩的
explicit formula【数】 - 显式公式
brake power - 制动功率 
stop button - 制动按钮 
exponential function - 指数函数 
power law - 指数定律 
instruction - 指令
thrust ball bearing - 止推滚珠轴承
primary system - 值统 
rectilineal - 直线的
d.c. - 直流
dc motor - 直羚动机 
mass defect - 质量缺陷 
quality evaluation - 质量评定 
quality criterion - 质量判据 
mass flow - 质量流 
mass flow rate - 质量潦
mass moment of inertia - 质量惯性矩
unit of mass - 质量单位
mass ratio - 质量比 
quality assurance - 质量保险 
materialization - 质化
system of particles - 质点系
particle dynamics - 质点动力学 
primary motion - 炙动 
manufacturer - 制造者
manufacturing technology - 制造工程 
manufacturing engineering - 制造工程 
manufacturing - 制造
heat shield - 挡热板 
fender - 挡泥板
apron - 挡板
fence - 挡板
elastic vibration - 弹性振动 
base plate - 底板 
base - 底板
cartesian coordinates - 笛卡儿坐标 
cryogenics - 低温学
pse - 等离子溅射复合刻蚀
plasma arc - 等离子弧 
isostatic pressing - 等静压制 
equivalent damping - 等价阻尼 
kerosene - 灯油
modulator - 灯器
ramming - 捣实
rammer - 捣棒
round off - 倒圆角 
adjusting valve - 第阀 
laplacian - 低量算符
lower atmosphere - 低层大气 
equiaxed - 等轴的
Isosceles - 等腰式射姿
isobaric - 等压的
equivalence principle - 等效原理 
equivalent system - 等效系统 
seismic wave - 地震波 
geostress - 地应力
subway - 地下铁道
underground explosion - 地下爆炸 
geostatic pressure - 地球静压力 
earth orbit - 地球轨道 
geodynamics - 地球动力学
pothole - 地面深穴
surface wind - 地面风 
geographic coordinates - 地理坐标 
geomagnetic storm - 地磁暴 
undercurrent - 底流下层流
Anvil - 底火砧座
primer - 底层色漆
electrode - 电焊条
arc welder - 电焊机 
electrical engineering - 电工学 
inductive load - 电感负载 
inductance - 电感
edm - 电腐蚀机
galvanizing bath - 电镀槽 
electric car - 电动汽车 
motor control - 电动机控制 
motor - 电动机;发动机
linear vibration - 线性振动 
rate of descent - 下降速度 
letdown - 下降
glide path - 下滑航迹 
bottom plate - 下固定板 
sag - 下垂
lower surface - 下表面 
refinement - 细微
fine crushing - 细碎 
necking - 细颈现象
smooth cut - 细锉纹 
slenderness ratio - 细长比 
slenderness - 细长比
system identification - 系统识别 
anchoring - 系泊
system - 系
hobbing - 铣刀
milling - 铣
LAV - 洗脸盆(Lavatory)
linear mapping - 线性映射 
linear elasticity - 线性弹性 
diagram - 线图
line voltage - 线电压 
modern control theory - 现代控制理论 
field test - 现场试验 
microstructure - 显微组织
microhardness - 显微硬度
microscopic test - 显微镜检验 
sensible heat - 显热 
chord - 弦
analogue method - 相似法 
similar - 相似的
coupled vibration - 相关振动 
relative flow - 相对怜 
relative height - 相对高度 
lower limit - 下限尺寸 
sag - 下弯
silencer - 消声器
fire extinguisher - 消火器灭火器 
consumption - 消耗量
rate of consumption - 消耗定额
consumption rate - 消耗比 
extinction - 消光
matt - 消光
rubber bearing - 橡胶轴承 
rubber band - 橡胶带 
speed of response - 响应速度 
response spectrum - 响应谱 
response analysis - 响应分析 
Click - 响
micromanipulator - 微操作
piston compressor - 往复式空气压缩机 
bending - 弯曲
folding - 弯曲
pipe bender - 弯管机 
outline - 外形
external effect - 外效应 
male thread - 外螺纹 
outer diameter - 外径 
grid structure - 网状结构 
strainer - 网式过滤器
rotary engine - 汪克尔发动机 
universal joint - 万向接头 
gimbal - 万向常平架
versatility - 万能性
perturbation method - 微扰法 
disturbance - 微扰
trace - 微量;描图
zein【生化】 - 玉米朊
oozing - 渗透
carburized layer - 渗碳层 
leak - 渗漏
very low frequency - 甚低频 
deep - 深水区
deep drawing - 深拉 
bathyscaphe - 深海潜水器
stretching - 伸展
expansion joint - 伸缩缝 
telescopic - 伸缩的
stretch - 伸长
degree centigrade - 摄氏温度 
degree celsius - 摄氏温度 
projection - 射影
productivity - 生产率
production schedule - 生产计划 
uptake - 上风口
superstructure - 上层结构
streamer - 闪流等离子柳
mesh - 筛孔
fluidics - 射控技术
piping - 设置管道
designer - 设计员
design speed - 设计速度 
design power - 设计功率 
project - 设计
grading - 筛分
sizing - 筛分
abrasive wheel - 砂轮 
grinding wheel - 砂轮 
mortar - 砂浆
design speed - 设计速度 
design power - 设计功率 
project - 设计
grading - 筛分
sizing - 筛分
abrasive wheel - 砂轮 
grinding wheel - 砂轮 
mortar - 砂浆
brake lining - 刹车摩擦片 
dune buggy - 沙漠用越野汽车 
scavenging - 扫气
scanner - 扫描装置
installed capacity - 设备容量 
coil - 蛇管
burn through - 烧蚀 
ablation - 烧蚀
agglomeration - 烧结
cope - 上型框
Feed - 上膛
tdc - 上死点
top view - 上视图 
lifting work - 上升功 
lifting height - 上升高度 
lifting - 上升
rise - 上升
stable state - 稳定状态 
stationary state - 稳定状态 
stable system - 稳定系 
stable orbit - 稳定轨道 
steady - 稳定的
permanent wave - 稳定波 
turbulence - 紊乱
turbulent flow - 紊流湍流 
turbulent - 紊聊
increase of temperature - 温度上升 
THS - 温度开关(Thermostat)
thermograph - 温度记录机
temperature measurement - 温度测量 
position control - 位置控制 
positional control - 位置控制 
position sensor - 位置检测器位置传感器 
formation of eddy - 涡旋形成 
vortex - 涡旋
turbocharger - 涡轮增压器
turboprop aircraft - 涡轮螺旋桨飞机 
turboprop - 涡轮螺旋桨发动机
turbogenerator - 涡轮发电机
eddy - 涡流旋流
frictionless - 无摩擦的
blind flange - 无孔法兰盘 
flushing - 冲洗，填缝
punch - 冲头;冲压工具
die plate - 冲模板 
stamping die - 冲模 
impulse - 冲量
impact force - 冲力 
punching - 冲孔
percussion - 冲击
shock response - 冲混应 
impact resistance - 冲昏力 
shock resistance - 冲昏力 
shock load - 冲簧重 
shock resistance - 冲豢度 
shock load - 冲缓载 
impact pressure - 冲还力 
stroke - 冲程
filling machine - 充填机 
inflation pressure - 充气压力 
gassing - 充气
charging time - 充电时间 
repulsive force - 斥力 
whole depth - 齿全高 
gear grinding - 齿轮磨削 
hob - 齿轮滚刀
gear drive - 齿轮传动 
cogwheel - 齿轮
addendum - 齿顶
scale effect - 尺度效应 
size effect - 尺寸效应 
dimensional accuracy - 尺寸精度 
oversize - 尺寸过大
dimensioning - 尺寸标注
rule - 尺
ruler - 尺
Follow-through - 持续射姿
relaxation - 弛豫
trim - 吃水差
draft - 吃水;通风
draught - 吃水
weighing - 秤量
weighing machine - 秤 
balance - 秤
scale - 秤
program control - 程序控制 
bearing power - 承重能力 
formability - 成型性能
lot production - 成批生产 
serial production - 成批生产 
cost accounting - 成本核算 
cost price - 成本 
island chain【海洋】 - 岛链
interior decorator【建】 - 室内装饰工
adapter【机】 - 附加件
rag【建】 - 石板瓦
braking coefficient【车辆】;braking ratio【车辆】 - 制动率
economic system reform【经】 - 经济体制改革
economic behaviour【经】 - 经济行为
economic depression【经】 - 经济萧条
dresser【机】 - 砂轮修整装置
dorsalis【动】 - 背侧动脉
dome【航】 - 航行舱
carcinogen【肿瘤】 - 致癌剂
carcinogenic effect【肿瘤】 - 致癌效应
carcass quality【畜牧】 - 胴体品质
buttocks【船】 - 船艄凸面
dry cleaning【矿】 - 干法选煤
drilling【矿】 - 打眼
dolly【矿】 - 提升绞车平衡重
dominant【数】 - 支配的
disturbed【气象】 - 扰动的
director【军】 - 指挥仪
discharge capacity【环境】 - 排污量
directional derivative【数】 - 方向导数
diesel oil【油气】 - 柴油
gin【机】 - 三脚起重机
intersection【交】 - 十字路口
unsteady flow【流】 - 非稳（恒）流（动）
encumbrance【财政】 - 保留支出数
embezzlement【法】 - 侵吞（财物）
rubber base【机】 - 胶座
round【矿】 - 炮眼组
bay window【建】 - 八角窗
axiom【数】 - 公理
numerical solution【数】 - 数值解
cystitis【泌尿】 - 膀胱炎
dog days【气候】 - 伏天
catalytic hydrogenation【油气】 - 催化氢化
lotus【建】 - 荷花饰
maximum probability【数】 - 最大概率
marquise【建】 - 挑棚
market model【经】 - 市场模型
manual【机】 - 手工操作的器械
manipulator【机】 - 推床
majority【数】 - 择多
lunette【建】 - 弧形窗
Adriatic【海洋】 - 亚得里亚海的
warm water【海洋】 - 暖水区
transfer characteristic - 传递特性 
transfer ratio - 传递比 
penetrating power - 穿透能力 
wave propagation - 波的传播 
wave packet - 波包 
parallel running - 并联运行 
parallel operation - 并联运行 
parallel connection - 并联 
handle - 柄
shank - 柄
bingham model - 宾汉模型 
surface quality - 表面质量 
skin effect - 表面效应 
surface displacement - 表面位移 
surface velocity - 表面速度 
surface defect - 表面缺陷 
profilometer - 表面光洁度仪
surface rigidity - 表面刚性 
surface roughness - 表面粗度 
normal pressure - 标准压力 
standard - 标准器
standard measure - 标准衡器 
norm - 标准
title block - 标题栏 
marking - 标示
scalar field - 标量场 
scale length - 标尺长度 
scoop - 杓子
variable mass - 变质量 
gearbox - 变速箱
transmission - 变速箱
control lever - 变速杆 
current transformer - 变流 
transformation theory - 变换论 
variational problem - 变分问题 
fluctuation - 变动
substation - 变电所
shallow shell - 扁壳 
slab - 扁钢坯扁钢锭
braiding machine - 编组机 
braided wire - 编织线 
edge stress - 边缘应力 
edge crack - 边缘裂缝 
borderline - 边线
slope failure - 边坡破坏 
boundary value - 边界值 
bem - 边界元法
boundary conditions - 边界条件 
boundary - 边界
boundary layer - 边层 
arm - 边
boom - 臂
lightning conductor - 避雷针 
vibration isolation - 振动绝缘 
vacuum forming - 真空成形 
frog - 辙岔
broken line - 折线 
reduced pressure - 折算压力 
vibration acceleration - 振动加速度 
shaker - 振动机
vibration exciter - 振动发生器振动激励器 
shaking - 振动
oscillation system - 振荡系 
lining - 炉衬
dew point hygrometer - 露点湿度表 
leak - 漏泄
leakage - 漏泄
funnel - 漏斗;烟囱
bulge - 隆起
tap - 龙头
gantry crane - 龙门起重机 
tire valve - 轮胎阀 
inflation - 轮胎阀
turret - 六角刀架
discharge rate - 瘤速率 
spout - 瘤口
run off - 瘤 
efflux - 瘤
direction of flow - 硫 
runner - 流道
current - 流
flow - 流
flow theory - 另论 
rheological equation - 龄学方程 
rheological behavior - 龄行为 
parts list - 零件表 
zero shift - 零点漂移 
pour point - 零 
profile grinding - 轮廓磨削 
outline - 轮廓
profile - 轮廓
wheel track - 轮距 
tyre - 轮箍;轮胎
wheel rim - 轮箍 
tire - 轮箍
disorientation - 乱取向
crawler tractor - 履带拖拉机 
crawler - 履带
aluminum oxide - 铝氧土 
alumina - 铝氧土
aluminum rivet - 铝铆钉 
subgrade - 路基
filter element - 滤过篇件 
friction heat - 摩擦热 
friction damper - 摩擦减震器 
internal furnace - 内燃烧室 
diesel railcar - 内燃机车 
female thread - 内螺纹 
nipple - 内接头
intrinsic - 内倌
interior ballistics - 内弹道学 
internal stress - 内部应力 
internal wave - 内波 
inner surface - 内表面 
nose over - 拿大顶 
wooden pole - 木桩 
flexibility - 挠性
deflection - 挠度
flexure - 挠度
forceps - 挠
aseismic - 耐震的
pressure line - 耐压管路 
resistance to heat - 耐热性 
refractoriness - 耐热度
abrasion resistance - 耐磨性 
resistance to abrasion - 耐磨性 
refractory lining - 耐火炉衬 
mallet - 木槌
wood working - 木材加工 
debris flow - 泥石流岩屑流 
energy system - 能源系统 
energy technology - 能源工程学 
energy cost - 能源费 
energy group - 能量组 
energy migration - 能量迂移 
energy loss - 能量损耗 
fire resistant - 耐火的 
resistance to impact - 耐冲辉 
shockproof - 耐冲荒
nano - 那
torsion bar - 扭杆 
newton method - 牛顿法 
kind of energy - 能量类型 
energy approximation - 能量近似 
energy recovery - 能量回收 
amount of energy - 能量 
transformation of energy - 能的转换 
energy loss - 能的损失 
ohm - 欧
enrichment - 浓缩
gel - 凝胶体
solidifying - 凝固
engage - 啮合
classifier - 分级机
classification - 分级
classifying - 分级
shim - 分隔片
segmentation - 分割
limb - 分度弧
distribution density - 分布密度 
distribution law - 分布律 
resolving power - 分辨能力 
containment - 封闭
wind pressure - 风压力 
wind pressure - 风压 
wind current - 风流 
wind turbine - 风力涡轮 
wind power - 风力 
wind force - 风力 
tuyere - 风口
wind channel - 风洞 
windshield - 风挡
windmill - 风车
pulverization - 粉碎
powder spraying - 粉末喷镀 
powder metal - 粉末金属 
slack - 粉煤
used air - 废气 
scale - 废料
dive - 俯冲
emissivity - 辐射系数
radiant heating - 辐射加热 
heat transfer by radiation - 辐射传热
swing - 幅
float - 浮子
floatation - 浮游选矿
bifurcation point - 分支点 
bifurcation - 分支
junction box - 分线箱 
analysis - 分析学
dispersibility - 分散性
dispersity - 分散性
recurrence rate - 复现率 
complex impedance - 复数阻抗 
complex mode - 复模态 
complex stress - 复合应力 
Laminated - 复合夹板
com - 复合加工
cow - 复合加工
float valve - 浮球阀 
buoyancy force - 浮力 
scaffold - 浮架
slot - 缝
miniature bearing - 微型轴承 
minicar - 微型小客车
micro motor - 微型电动机 
potential theory - 位势论 
potential - 位势
unknown - 未知的
incomplete fusion - 未焊透 
sanitary engineering - 卫生工程学 
stern tube - 尾轴管 
wake - 尾流伴流
tail rotor - 尾部螺旋桨 
tail - 尾部
pseudoplasticity - 伪塑性
pseudopotential - 伪势
maintainability - 维修保养方便性
maintenance - 维修
vickers hardness - 维氏硬度 
weibull distribution - 韦布尔分布 
discrete probability distribution【数】 - 离散概率分布
dining room【建】 - 饭厅
discrete element method【数】 - 离散元素法
discrete function【数】 - 离散函数
trichobothria【昆】 - 毛点
oil-producing country【油气】 工经 - 产油国
scarab【昆】 - 金龟子
logical function【数】 - 逻辑函数
rolling diameter【机】 - 滚圆直径
rheological property【力】 - 流变性质
residual gas【化工】 - 残余气体
heterogeneity【矿】 - 不均质性
runway【航】 - 跑道
rotor speed【机】 - 转子转速
rolling mill【机】 - 轧钢厂
Riedel's disease【内科】 - 里德耳氏病
loop【古生】 - 环台面
patter【建】 - 镘板
leukotriene【生化】 - 白三烯
legal entity【法】 - 法律实体
御夫座β【天】 - β Aur
papillary thyroid carcinoma【肿瘤】 - 乳头状甲状腺癌
pairwise【数】 - 两两的
capital contribution【经】 - 资本捐赠
collocation method【数】 - 配置方式
stress-strain【力】 - 应力应变
stock【木】 - 木工刨
stockade【建】 - 木栏
stockpile【矿】 - 料堆
petroleum distillate【油气】 - 石油馏分
petroleum refining【油气】 - 石油炼制
pencil【林】 - 美国圆柏
holder - 夹具
fixture - 夹紧装置
fastening device - 夹紧机构 
sandwich construction - 夹层结构 
filling station - 加油站 
cassette - 胶卷暗盒
offset press - 胶版印刷机 
pouring - 浇铸
pouring temperature - 浇注温度 
runner - 浇注晾
teeming - 浇注
gate - 浇口
check list - 检查表 
check - 检查
checking - 检查
shear stress - 剪应力 
shear mode - 剪切振模 
shear test - 剪切试验 
shear modulus - 剪切模数 
shear - 剪切
pincers - 剪钳
shearing flow - 剪流 
trimmer - 剪边机
damping - 减震
damping force - 减振力 
contact resistance - 接触电阻 
First Catch - 接触点 
ac - 交流交变电流
heat regenerator - 交粱热器 
exchange rate - 交换速率 
exchange resonance - 交换共振 
staggered arrangement - 交错配置 
intersection point - 交叉点 
cross elasticity - 交叉弹性 
intersection - 交叉
changing load - 交变负载 
downcomer - 降水管
DN - 降(下)(Down)
paddle - 桨叶
pulp - 浆
arrowhead - 箭头
keyboard control - 键盘控制 
isd - 溅射蒸涂
evolute - 渐开线
hierarchy - 阶层
agitator - 搅拌器
articulated - 铰链的
ream - 铰孔
reaming - 铰孔
foot control - 脚踏操纵 
motive force - 原动力 
element - 元件
region - 域
antechamber - 预燃室
remote controlled - 远距离操纵的 
distance control - 远距控制 
distant control - 远距控制 
far infrared rays - 远红外线
cylindrical shell - 圆柱壳 
circular motion - 圆周运动 
Crown - 圆整枪口
preload - 预负荷
preset - 预蝶
stand by - 预备的 
load curve - 载荷曲线 
inclusion - 杂质
operation test - 运转试验 
operating conditions - 运行条件 
running test - 运行试验 
freighter - 运输机
haulage - 运输
law of motion - 运动律
slag - 渣
breeder - 增殖反应堆
booster - 增压器
plasticizing - 增塑
speedup - 增速
reinforced composite - 增强复合材料 
augmentation - 增加
noise elimination - 噪音防止 
noise power - 噪声功率 
motion equation - 运动方程 
equation of motion - 运动方程
moon rover - 月球车 
adhesive - 粘着剂
adhere - 粘着
viscous drag - 粘滞阻力 
viscous friction - 粘滞摩擦 
viscous drag - 粘性阻力 
viscous fluid - 粘性铃 
viscous flow - 粘性怜 
tenacity - 粘性
toughness - 粘性
viscoplastic - 粘塑性的
viscous fluid - 粘力 
rumble - 噪声
blacking - 造型涂料
molding - 造型
moulding - 造型
shipbuilding yard - 造船厂 
hydrometer - 比量计
proportional control - 比例控制 
specific power - 比功率 
resistivity - 比电阻
specific surface - 比表面 
pumping pressure - 泵压力 
pumpability - 泵送能力
pump head - 泵的压头 
collapse - 崩溃
multiple - 倍数
back pressure - 背压力 
back pressure - 背压 
repair parts - 备件 
spare - 备件
explosive working - 爆炸加工 
puncture - 爆坏
detonation wave - 爆轰波 
outburst - 爆发
warning device - 报警装置 
service personnel - 保修人员 
lagging - 保温
conformal mapping - 保角映射 
protective device - 保护装置 
guard - 保护装置
shielding gas - 保护气体 
holding time - 保持时间 
wrapper - 包装机
packing list - 包装单 
envelope - 包络线
coating - 包复
covering - 包复
steam condenser - 棒式松砂机 
bar steel - 棒钢 
wake - 伴流
button head - 半圆头 
office computer - 办公计算机 
plate structure - 板结构 
Disconnector - 扳机脱离钩
pendulum effect - 摆效应 
rocker - 摆杆
rocking - 摆动的
hunting - 摆动
LV - 百叶(Louver)
convolution【数】 - 卷积
cooperation【经】 - 协作
cool summer【气象】 - 冷夏
cooling jacket【机】 - 冷却套管
catalytic reforming【油气】 - 催化重整
lamb【畜牧】 - 羊羔
kite【船】 - 筝帆
weights and measures - 度量衡 
number of boundary【数】 - 边界数
notation【数】 - 记法
beachhead【军】 - 滩头堡
face【机】 - 切削面
adopter【化工】 - 接受管
adult【动】 - 成体
theoretical value - 理论值 
mile - 哩
odometer - 里程计
plowshare - 犁铧
ionic liquid - 离子液体 
ion impact - 离子碰撞 
ion diffusion - 离子扩散 
cube - 立方体
mechanical system - 力学系 
mechanical energy - 力学能 
mechanics - 力学
ion etching - 离子刻蚀 
ie - 离子刻蚀
ion trajectory - 离子轨道 
ion plating - 离子镀敷 
centrifugal separator - 离心分离机 
discrete element method - 离散单元法 
continuous system - 连续系统 
continuous random variable - 连续随机变量 
continuous flow - 连续怜 
force density - 力密度 
force sensor - 力传感器 
force field - 力场 
chain conveyor - 链式运输器 
continuous medium - 连续介质 
continuous process - 连续工程 
continuity equation - 连续方程 
continuous wave - 连续波 
chain reaction - 连锁反应 
connecting rod - 连结棒 
connection - 连结
tie - 连接杆
joint - 连接
juncture - 连接
fluidization - 连化
connecting rod - 连杆 
particle flow - 粒子流 
grain size analysis - 粒度分析 
grain size - 粒度 
grain - 粒
utilization factor - 利用率 
stereoscopic camera - 立体摄影机 
elevation - 立视图
torque - 转矩
center of rotation - 转动中心
sprue - 注道
helper - 助手
heading - 追
impact - 撞击冲击
ram - 撞凰
phase diagram - 状态图 
state feedback control - 状态反馈控制
state variable - 状态参数 
regime - 状态
Load - 装药剂量
charge - 装药
palletizer - 装托盘机
rotating - 转动的
transition state - 转变状态 
transition region - 转变区 
effort - 酌力
application point - 酌点 
action - 酌
turbidity current - 浊流 
degree of accuracy - 准确度
assembly drawing - 装配图 
assembly process - 装配过程 
assembly technology - 装配工艺 
erector - 装配工
assembly plant - 装配厂 
armored cable - 装甲缆 
armor plate - 装甲板 
Loading port - 装弹口 
equip - 装备
pile foundation - 桩基础 
pile - 桩
rotameter - 转子量计
rotator - 转子
transposed matrix - 转置矩阵 
power feed - 自动进给 
automatic checking - 自动检验 
recorder - 自动记录器
g function - 准备功能 
coning - 锥旋
conical surface - 锥面 
taper angle - 锥角 
taper turning - 锥度切削车圆锥 
atc - 自动换刀装置
automatic welding machine - 自动焊机
automatic spot welding - 自动点焊
automatic pilot - 自动导航装置 
atr - 自动带读出器
automated warehouse - 自动仓库 
electric equipment - 电气设备 
electrohydrodynamics - 电铃力学
dynamic characteristic - 动态特性 
dynamic simulation - 动态模拟 
dynamic analysis - 动态分析 
steady detonation - 定常爆轰 
center - 顶尖
ejector sleeve - 顶出衬套 
butterfly valve - 蝶形阀 
fly valve - 蝶形阀 
regulator - 蝶器第器
adjusting bolt - 蝶螺栓 
regulation - 蝶
superposition - 叠加
laminated plate - 叠层板 
iteration method - 迭代法 
momentum conservation - 动量守恒 
momentum integral - 动量积分 
dynamic model - 动力学模型 
power consumption - 动力消耗 
dynamic system - 动力系统 
dynamical system - 动力系统 
power unit - 动力头 
dynamic property - 动力特性 
dynamic model - 动力模型 
utility boiler - 动力锅炉 
power reactor - 动力堆 
dynamic instability - 动力不稳定 
fracture - 断裂
disconnection - 断开
tomography - 断层摄影
fault plane - 断层面 
short circuit - 短路 
short wave - 短波 
terminal - 端子
face grinding - 端面磨削 
end plane - 端面 
terminal - 端的
Coating - 镀膜
gilding - 镀金
buster - 堵口
loading - 堵
independence - 独立
reader - 读出装置
freezer - 冻结装置
freezing method - 冻结方法 
freezing method - 冻结法 
dynamic pressure - 动压力 
dynamic behavior - 动态行为 
dynamic error - 动态误差 
pressure regulator【机】 - 压力调节器
interior decoration【建】 - 内部装饰用物
office operation【建】 - 室内加工
noise monitoring【环境】 - 噪声监测
native grass【畜牧】 - 天然牧草
transpiration【气象】 - 蒸腾
proportional number【经】 - 比例数
production waste【环境】 - 生产废料
product development【经】 - 产品发展
prey【林】 - 猎物
pound【畜牧】 - 牲畜栏
positive integer【数】 - 正整数
untempered【机】 - 未回火的
camera【法】 - 审判员密议室
business industry【工经】 - 商办工业
Braconidae【昆】 - 小茧蜂科
bogie【机】 - 台床
basic plan【经】 - 基本方案
basic frame【机】 - 基架
basal cell【昆】 - 基室
banquette【建】 - 台坎
termination【妇产】 - 终止妊娠
mechanical stability【机】 - 机械稳定性
mechanical error【机】 - 机械上的错误
mechanical wave【力】 - 机械波
mechanical impedance【力】 - 机械阻抗
mechanical analysis【力】 - 机械分析
machine part【机】 - 机器零件
liquidator【法】 - 财产清算人
inverse regression【数】 - 逆回归
corporate body【法】 - 法人团体
contaminated soil【环境】 - 污染土壤
constrictor【航】 - 燃烧室收缩段
concentration【物】 - 浓度
concomitant【数】 - 相伴的
concrete column【建】 - 混凝土柱
comparison test【经】 - 比较检验
holder【机】 - 刀杆柄
