细胞生物学百科

spermatogenesis - 精子发生
segmentation gene - 分节基因
segment polarity gene - 体节极性基因
regulatory gene - 调控基因
pseudogene - 假基因
proto-oncogene - 原癌基因
parthenogenesis - 单性生殖
pair-rule gene - 成对基因
gynogenesis - 雌核发育
gluconeogenesis - 糖异生
genetic marker - 遗传标记
genetic code - 遗传密码
gene transfer - 转基因
gene mapping - 基因作图
gene therapy - 基因治疗 
Gene families - 基因家族
gene deletion - 基因删除
gene amplification - 基因扩增
gap gene - 间隙基因
agamogenesis - 无性生殖
angiogenesis - 血管生成 
oncofetal protein - 癌胚蛋白
β-amyloid protein precursor - 淀粉样蛋白前体
trimeric gtp-binding regulatory protein - 三聚体GTP结合调节蛋白
small g protein - 小G蛋白
protein-serine/threonine kinase - 蛋白丝氨酸/苏氨酸激酶 
proteinfolding - 蛋白质折叠
protein traffic - 蛋白质（的）运输 
peripheral membrane protein - 外周蛋白
multidrug resistance protein - 人类多药抗性蛋白
low-density lipoproteins - 低密脂蛋白
ironsulfur protein - 铁硫蛋白
integral membrane protein - 整合蛋白
heat shock protein - 热休克蛋白
GTPase activating protein - GTP酶激活蛋白
G-protein-linked receptor - G蛋白耦联型受体 
glycoprotein - 糖蛋白
glial fibrillary acidic protein - 胶质原纤维酸性蛋白
coat protein - 衣被蛋白
amyloid protein - 淀粉样蛋白
transacting factors - 反式作用因子
transcription factor - 转录因子
maturation promoting factor - 成熟促进因子 
guanine-nucleotide exchange factor - 鸟苷酸交换因子
split gene - 断裂基因
tumorigenesis - 肿瘤发生 
oncogenesis - 肿瘤发生 
carsinogenesis - 肿瘤发生 
tumor suppress gene - 抑癌基因 
transgene - 转基因
spermiogenesis - 精子形成
B cell antigen receptor - B细胞抗原受体
B cell - B细胞
unipotent stem cell - 单能干细胞
pluripotent stem cell - 多能干细胞
hemopietic stem cells - 造血干细胞
T-cell - T细胞
cell synchronization - 细胞同步化
programmed cell death - 程序性细胞死亡
prokaryotic cell - 原核细胞
inclusion-cell disease - 细胞内含物病
extracellular matrix - 细胞外基质
cell division - 细胞分裂
cell cycle - 细胞周期
cell cortex - 细胞皮层
cell communication - 细胞通讯
cell adhesion molecule - 细胞粘附分子
B-cell - B细胞
Amniotic Fluid-derived Stem-cell - 羊水干细胞
umbilical cord blood-derived stem cell - 脐带血干细胞
gene expression - 基因表达
cell culture - 细胞培养
gene recombination           - 基因重组
lipid-anchored protein - 脂锚定蛋白
unit membrane model - 单位膜模型
transport ATPase - 运输ATPase
Nucleostemin - 核干细胞因子
neural stem cell - 神经干细胞
cell differentiation - 细胞分化（作用）
channel protein - 通道蛋白
carrier protein - 载体蛋白
necroptosis - 坏死性凋亡
biomembrane system - 生物膜结构体系
peripheral protein - 外周蛋白
Lamella structure model - 片层结构模型
induced pluripotent stem cell - 诱导型多潜能干细胞，诱导性多功能干细胞，诱导性多功能干细胞
aquaporin - 水通道蛋白
cotransport - 协同运输
molecular chaperones - 分子伴侣
cell fusion - 细胞融合
paraptosis - 类凋亡
parthanatos - PARP-1依赖性细胞死亡
totipotent stem cell - 全能干细胞
chloroplast - 叶绿体
oncosis - 胀亡
unfoldedprotein response - 未折叠蛋白反应
entosis - 细胞侵入性死亡，内吞死亡
anoikis - 失巢凋亡
transmembrane proteins - 跨膜蛋白
neurofilament protein - 神经纤丝蛋白，神经丝蛋白
voltage-gated channels - 电压门控通道,电位-门控通道
bone marrow stromal cell  - 骨髓基质细胞
electron spin-resonance spectroscopy，ESR - 电子自旋共振谱技术
radioactive labeling procedure - 膜蛋白放射性标记法
band 3 protein - 带3蛋白
neurofilament protein - 神经纤丝蛋白，神经丝蛋白
transmembrane proteins - 跨膜蛋白
gene library - 基因文库
muhivesicular body - 细胞内多泡体
somatic stem cell - 成体干细胞
phosphorylating transport - 磷酸化运输
Asian-Pacific Organization for Cell Biology,APOCB  - 亚洲及太平洋地区细胞生物学
membrane skeleton, skeleton structure of cell membrane  - 细胞膜骨架结构,膜骨架
Chinese Society for Cell Biology,CSCB  - 中国细胞生物学学会
International Federation for Cell Biology,IFCB  - 国际细胞生物学会联合会
eukaryotic cell, eukaryocyte - 真核细胞
filensin - 晶状体丝蛋白
band 4.1 protein - 带4.1蛋白
transverse diffusion,flip-flop - 翻转扩散
cellular transport - 细胞运输
membrane transport protein - 膜运输蛋白
pericentriolar material (PCM)，centrosome matrix - 中心粒周物质，中心体基质
twinfilin - 双解丝蛋白
microtubule repetitive protein (MARP) - 微管重复蛋白
ATP synthase - ATP合酶
central granule，central plug - （核孔复合体）中央颗粒，中央栓
tissue inhibitor of metalloproteinase（TIMP） - 组织金属蛋白酶抑制物
genetic expression system - 遗传信息表达结构系统
cytoskeletonic system - 细胞骨架系统
protoplasm theory - 原生质理论
receptor tyrosine protein kinase - 受体酪氨酸蛋白激酶
receptor tyrosine protein phosphatase（RPTP） - 受体酪氨酸蛋白磷酸酶
receptor serine/threonine protein kinase（STPK） - 受体丝/苏氨酸蛋白激酶
dual-specifity phosphatases - 双重底物特异性蛋白磷酸酶
molecular biology of the cell, molecular cellular biology - 分子细胞生物学
ligand gated channel - 配体门控通道
stretch-gated channel - 胁迫门控通道
actin depolymerizing factor（ADF） - 肌动蛋白解聚因子
embryonic stem cell - 胚胎干细胞
G-protein - G 蛋白
I region associated antigen - I 区相关抗原
MHC restriction - MHC 限制性
PAP staining, peroxidase-anti-peroxidase staining - PAP 染色
dictyosome - [分散]高尔基体
intercellular transport - 胞间运输
cytostome - 胞口
intracellular transport - 胞内运输
homeologous chromosome - 部分同源染色体
differential centrifugation - 差速离心
modulation - 调变
limosphere - 顶体球
polyclonal compartment - 多克隆发育区
polyembryony - 多胚性
high mobility group protein, HMG protein - 高速泳动族蛋白
preformation - 先成论
blastogenesis - 芽基发育
sub-protoplast - 亚原生质体
spherosome - 圆球体
centroplast - 中心质体
autogamy, idiogamy - 自体受精
metaplasia - 组织转化
androgenesis - 孤雄发育
intranuclear spindle - 核内纺锤体
mesosome - 间体
Casparian band, Casparian strip - 凯氏带
stereomicroscope, dissecting microscope - 立体显微镜
lymphokine-activated killer cell, LAK cell - 淋巴因子激活的杀伤细胞
nullisome - 缺对[染色体]生物
biogenesis - 生源论
germ plasm - 生殖质
glycocalyx - 糖萼
explant - 外植块
microtubule organizing center - 微管组织中心
temperature-sensitive mutant - 温度敏感突变体
immortalization - 无限增殖化
cytokinin - 细胞分裂素
nuclear basket - 核篮
spokein - 辐蛋白
acid hydrolase - 酸性水解酶
microspike - 微棘
claudin - 封闭蛋白，封闭素
internexin - 介连蛋白
centrophilin - 亲中心体蛋白
mitoribosome - 线粒体核糖体
Schwann cell - 许旺细胞 雪旺细胞 施旺细胞
calreticulin - 钙网蛋白
stathmin - 微管去稳蛋白
scaffold protein - 支架蛋白质
lipid raft - 脂筏
destrin - 破解蛋白
cofilin - [微丝]切割蛋白
protein kinase - 蛋白激酶 
nerve growth factor (NGF) - 神经生长因子
connexon - 连接子
centromere - 着丝粒染色体上的一段非编码的DNA，对动粒（或动粒蛋白）有组织和整合作用。
biogenesis - 生源论又称“生源说”。
telomere - 端粒
gene bank - 基因库
pellicle - 表膜
hemidesmosome - 半桥粒
genomic library - 基因组文库
glycocalyx - 糖萼又称“多糖包被”。
ultrastructure - 超微结构
centriole - 中心粒
kinetochore - 动粒细胞分裂中期联接着丝粒微管并提供动力的盘状蛋白复合体。
leucoplast - 白色体
nuclear envelope - 核被膜
thylakoid - 类囊体
spherosome - 圆球体见于植物。
heterochromatin - 异染色质
vacuole - 液泡简称“泡”。
Robertsonian translocation - 罗伯逊易位
micropipette - 微量加液器
microscope - 显微镜
microscopy - 显微术
subcloning - 亚克隆[化]
cell wall - 细胞壁
autopolyploidy - 同源多倍性
allotype - 同种异型
suspension culture - 悬浮培养
defined medium - 已知成份培养液
mitochondrial DNA - 线粒体 DNA
mosaic - 镶嵌型
euploidy - 整倍性
integrin - 整联蛋白
recombinant DNA - 重组 DNA
transferrin - 运铁蛋白
hybridoma cell line - 杂交瘤细胞系
self-assembly - 自组装
metaplasia - 组织转化
 - 
adult stem cell - 成体干细胞
monohybrid - 单基因杂种
tonoplast - 液泡形成体又称“液泡膜”。
cytostome - 胞口见于原生动物。
nucleosome - 核小体
micronucleus - 小核见于原生动物。
plastid - 质体
nucleoid - 拟核又称“类核”。
peroxisome - 过氧化物酶体
chromosome rearrangement - 染色体重排
cytoskeleton - 细胞骨架
cyst - 孢囊又称“胞囊”。
pyrenoid - 淀粉核
sarcomere - 肌[原纤维]节
euchromatin - 常染色质
Multipotent - 多潜能的，复合潜能的
Archaea - 古菌域
Bacteria - 细菌域
Homo sapiens - 人（拉丁文）
thioredoxin reductase - 硫氧还蛋白还原酶
sarcoplasmic reticulum - 肌质网
constriction - 缢痕
Stem Cell Niche - 干细胞巢,干细胞微环境
osmophilic - 嗜锇小体
pioneering fiber - 先驱纤维
sexuality - 性别
sex differentiation - 性别分化
aster - 星体
astrosphere - 星体球
cell count - ①细胞数②细胞数的测定
cell age - 菌龄
cell-mediated immunity - 细胞性免疫
cell　 - ①细胞②盒；槽；池；浸提器
cell membrane - （细）胞膜
syncytiotrophoblast - 合体滋养细胞
cytotrophoblast - 细胞滋养细胞
Epidermal-like Stem Cells - 表皮样干细胞
biogenesis - 生物发生论
embryogenesis - 胚胎发育
epigenetic - 核外遗传 
cellular immunology - 细胞免疫学
fibronectin - 纤连蛋白
cytokinin - 细胞分裂素
cell engineering - 细胞工程
karyology - 细胞核学
cytomixis - 细胞混合
cytometry - 细胞计量术
cytotoxin - 细胞毒素
cyclin - 细胞周期蛋白
cell morphology - 细胞形态学
cell theory - 细胞学说
apyrene sperm - 无核精子
adjuvant - 佐剂
vacuole - 液泡
primary cell culture - 原代细胞培养
transgenic plant - 转基因植物
autophagy - 自[体吞]噬
autocrine - 自分泌
transformation efficiency - 转化率
active transport - 主动运输
transdifferentiation - 转分化
acridine orange - 吖啶橙
acridine yellow - 吖啶黄
sporocyte - 孢母细胞
midbody - 中间体
neutral red - 中性红
plasma membrane - 质膜
neoplastic transformation - 致瘤性转化
sensitization - 致敏
tonoplast - 液泡形成体
plasminogen - 血纤维蛋白溶酶原
glycophorin - 血型糖蛋白
hybrid cell line - 杂交细胞系
slide - 载玻片
nexin - 微管连接蛋白
immortalization - 无限增殖化
cytolysin - 溶细胞素
triploidy - 三倍性
trisome - 三体[染色体]生物
cryopreservation - 深低温保藏
biogenesis - 生源论
germ plasm - 生殖质
stage specific - 时期专一
doublet - 双联体
two dimensional gel electrophoresis - 双向凝胶电泳
cryofixation - 冷冻固定
freeze-etching - 冷冻蚀刻
light green - 亮绿
thionine - 硫堇
retrograde axonal transport - 逆行轴突运输
embryo culture - 胚胎培养
petri dish - 培养皿
gametogenesis - 配子发生
confluent culture - 铺满培养
proplastid - 前质体
potency - 潜能
colchicine - 秋水仙素
chemotaxis - 趋化性
kinesin - 驱动蛋白
population density - 群体密度
chromatin condensation - 染色质凝聚
feeder layer - 饲养层
glycocalyx - 糖萼
somatic cell - 体细胞
rDNA - 核糖体 DNA
pseudocyst - 假孢囊
gap junction - 间隙连接
pararosaniline - 碱性副品红
basic fuchsin - 碱性品红
epigenesis - 渐成论
glial fibrillary acidic protein - 胶质细胞原纤维酸性蛋白
contact inhibition - 接触抑制
desmin - 结蛋白
bindin - 结合蛋白
shoot tip culture - 茎尖培养
antiserum - 抗血清
Coomassie blue - 考马斯蓝
cloning - 克隆[化]
clonal variant - 克隆变异体
clonal propagation - 克隆繁殖
quick freezing - 快速冷冻
Langerhans cell - 朗氏细胞
cryoprotectant - 冷冻保护剂
rhodamine - 罗丹明
ankyrin - 锚蛋白
immuno-gold-silver staining - 免疫金-银染色
immunological tolerance - 免疫耐受
immunohistochemical method - 免疫组织化学法
endocrine - 内分泌
endomembrane system - 内膜系统
secretion - 分泌
meristem culture - 分生组织培养
molecular cloning - 分子克隆化
molecular recognition - 分子识别
negative staining - 负染[色]
root culture - 根培养
co-culture - 共培养
symport - 共运输
parthenogenesis - 孤雌发育
androgenesis - 孤雄发育
myeloma cell - 骨髓瘤细胞
lamin - 核纤层蛋白
intine - 花粉内壁
pollen culture - 花粉培养
extine - 花粉外壁
chemoattractant - 化学引诱物
etioplast - 黄化质体
vital dye - 活体染料
basement membrane - 基底膜
gene map - 基因图[谱]
laser scanning confocal microscope - 激光扫描共焦显微镜
epidermal growth factor, EGF - 表皮生长因子
sterility - 不育性
differential centrifugation - 差速离心
differential expression - 差异表达
ultracentrifuge - 超速离心机
megaspore - 大孢子
megasporocyte - 大孢子母细胞
orcein - 地衣红
modulation - 调变
commitment - 定型
dynein - 动力蛋白
antiport - 对向运输
polyploidy - 多倍性
safranine - 番红
spindle - 纺锤体
connexin - [间隙连接]连接蛋白
hybridoma - [淋巴细胞]杂交瘤
blastocyst - [囊] 胚泡
permeability - [通]透性
intercellular space - [细]胞间隙
cell membrane - [细]胞膜
cytoplasm - [细]胞质
ruffling - [细胞]边缘波动
cell differentiation - [细胞]分化
blastema - [再生]芽基
aminopterin - 氨基蝶呤
exocytosis - 胞吐[作用]
endocytosis - 胞吞[作用]
cyclosis - 胞质环流
cytosol - 胞质溶胶
passage - 传代
mitogen - 促[细胞]分裂原
Fc receptor - Fc 受体
G-protein - G 蛋白
M phase - M 期
MHC restriction - MHC 限制性
S phase - S 期
T-cell receptor - T 细胞受体
dictyosome - [分散]高尔基体
gelsolin - [肌动蛋白]凝溶胶蛋白
vinculin - 粘着斑蛋白
puff - 胀泡
eukaryon - 真核
phycobilisome - 藻胆体
fucoxanthin - 藻褐素
amyloplast - 造粉[质]体
proliferation - 增殖
preconditioning - 预处理
cord blood mononuclear cells - 脐血单个核细胞
image reconstruction - 图象重构
excrine - 外分泌
explantation - 外植
explant - 外植块
cell fractionation - 细胞分部分离
air cell - （蛋的）气室
vitellogenesis - 卵黄生成 
claudin - 封闭蛋白，封闭素
cell aggregate - 细胞团块；细胞团块
nestin - 巢蛋白
cellular signal transduction - 细胞信号转导
proapoptotic - 前凋亡的
vacuoles - 液泡
zona pellucida - 透明带
pattern formation - 图式形成
vesicle - 小泡
conditioned medium - 条件培养液
protooncogene - 原癌基因
lucifer yellow - 萤光黄
karyote - 有核细胞
spectrofluorometer - 荧光分光光度计
fluorescent probe - 荧光探针
subclone - 亚克隆
carmine - 洋红
tubulin - 微管蛋白
cancer stem cell - 癌症干细胞
