肿瘤百科

renal carcinoma - 肾癌
Multiple chondroma - 多发性软骨瘤
epithelial-mesenchymal - 上皮-间充质
mustine - 氮芥
monopartite - 单组分
hypoosmotic - 低渗液
mk - 标记
mage - 基于mage
diosgenin - 薯蓣皂苷配基
chlorin - 二氢卟酚
counterattack - 反向攻击
appendixes - 附件骨
anticarcinogenic - 抗癌的
sal - 沙尔
ceramidase - 神经酰胺酶
alimentarius - 消化道
dihydrodiol - 二氢二醇
mage - 针对mage
nevocellular - 黑色素细胞
ewing - 尤因
meninges - 脑脊膜
tent - 塞条
raji - raji肿瘤
subcategories - 亚群
chemosensitivity - 化疗敏感
gleason - 标本gleason
polyadenylation - 多聚腺苷酸化
gleason - gleason分级
registry - 登记处
mimicry - 拟态
