药学百科

Pomalidomide - 泊马度胺
Cabozantinib - 卡博替尼
Mipomersen；Kynamro - 米泊美生
Riociguat - 利奥西呱
Avanafil - 阿伐那菲
Ezetimibe - 依泽替米贝
zoledronic acid; Zometa - 密固达;唑来膦酸;择泰
Sovaldi - 索非布韦片
Ponatinib - 普纳替尼
Omacetaxine;homoharringtonine - 高三尖杉酯碱
Mirabegron - 米拉贝隆
Oseltamivir - 奥司他韦
Stagliptin - 西他列汀
Linagliptin - 利拉利汀
Breo Ellipta - 糠酸氟替卡松/三苯乙酸维兰特罗吸入粉
Tafinlar - 甲磺酸达拉非尼胶囊
Eylea；aflibercept - 阿柏西普
Linagliptin - 利拉利汀
Xofigo - 氯化镭-223注射液
Gilotrif - 马来酸阿法替尼片
bazedoxifene - 巴多昔芬
Macitentan - 马西替坦
Enzalutamide；Xtandi - 恩杂鲁胺
Glucarpidase - 谷卡匹酶
Lomitapide - 洛美他派
Daliresp;roflumilast - 罗氟司特
Teriflunomide - 特立氟胺
Gefitinib - 吉非替尼
Teduglutide - 替度鲁肽
Trabectedin - 曲贝替定
Adempas - 利奥西呱片
vilanterol - 维兰特罗
Tecfidera - Invokana;canagliflozin
Invokana;canagliflozin - 卡格列净
Horizant;gabapentin enacarbil - 加巴喷丁恩那卡比
Canagliflozin - 坎格列净
Alogliptin - 阿格列汀
Luzu - 卢立康唑乳膏
Inlyta - 阿昔替尼
Apixaban - 阿哌沙班
Elvitegravir - 埃替格韦
Aclidinium Bromide - 阿地溴铵
Eribulin - 艾日布林
Mekinist - 曲美替尼胶囊
Firazyr; icatibant - 艾替班特
Dabrafenib - 达拉菲尼
Trametinib - 曲美替尼
Afatinib - 阿法替尼
Tafluprost - 他氟前列腺素
Linaclotide - 利那洛肽
spectrophotometry - 紫外分光光度法
ofloxacin - 氧氟沙星
accurate - 结果准确
uv - 紫外分光光度法
dissolution - 溶出
tablet - 片剂
pharmacokinetics - 药代动力学研究
tinidazole - 替硝唑
pharmacopoeia - 药典
hplc - 反相高效液相色谱法
diclofenac - 双氯芬酸
release - 释放度
endotoxins - 内毒素
gatifloxacin - 加替沙星
assay - 含量测定
theophylline - 茶碱
delivery - 给药
transdermal - 透皮
formulation - 处方
dispersible - 分散
paracetamol - 对乙酰氨基酚
pharmacokinetics - 药动学研究
pharmaceutical - 药学
roxithromycin - 罗红霉素
phenobarbital - 苯巴比妥
phenytoin - 苯妥英
rp - 反相
gel - 凝胶剂
bioavailability - 生物等效性
pharmacokinetic - 药物动力学
injections - 注射液
dihydrogen - 二氢
pellets - 微丸
dihydrogen - 磷酸二氢
pyrogen - 热原
compatible - 配伍
spray - 喷雾剂
lomefloxacin - 洛美沙星
ketoconazole - 酮康唑
bioequivalent - 生物等效性
suppository - 栓剂
antiarrhythmic - 抗心律失常
percutaneous - 透皮
limulus - 鲎
prescriptions - 处方
formulation - 制剂
mesylate - 甲磺酸
effervescent - 泡腾
ketoprofen - 酮洛芬
pharmacy - 药房
capsules - 胶囊剂
liniment - 搽剂
irritation - 刺激性
ornidazole - 奥硝唑
telmisartan - 替米沙坦
aggregation - 聚集作用
adr - 不良反应
formula - 处方
gliclazide - 格列齐特
tal - 鲎试剂
capsule - 胶囊剂
loratadine - 氯雷他定
cefotaxime - 头孢噻肟钠
enoxacin - 依诺沙星
film - 膜剂
convolution - 褶合
adr - 药品不良反应
cefaclor - 头孢克洛
cefixime - 头孢克肟
pharmacokinetics - 体内药代动力学
suspension - 混悬剂
uv-spectrophotometry - 紫外分光光度法
cross-over - 交叉
suppositories - 栓
trimethoprim - 甲氧苄啶
pefloxacin - 培氟沙星
cefoperazone - 头孢哌酮钠
absorbance - 吸收度
valproic - 丙戊酸
pseudoephedrine - 盐酸伪麻黄碱
cbz - 卡马西平
pharmacist - 药师
diphenhydramine - 苯海拉明
cefradine - 头孢拉定
hepatotoxicity - 毒性
cilostazol - 西洛他唑
procaine - 盐酸普鲁卡因
pharmacokinetics - 药物代谢动力学
clavulanate - 克拉维酸
pilocarpine - 毛果芸香碱
adefovir - 福韦
preclinical - 临床前
anticonvulsant - 抗惊厥
carbomer - 卡波姆
cefazolin - 头孢唑林
sterility - 无菌
cefaclor - 头孢克罗
hepatotoxicity - 肝毒性
promethazine - 盐酸异丙嗪
suppositories - 栓剂
clobetasol - 氯倍他索
influx - 内流的
cephalexin - 头孢氨苄
adefovir - 阿德
adefovir - 阿德福韦
diphenhydramine - 盐酸苯海拉明
rifapentine - 利福喷丁
liniment - 擦剂
quinolones - 喹诺酮类药物
acetaminophen - 扑热息痛
disintegrating - 崩解
tegafur - 替加氟
tegafur - 加氟
cefuroxime - 头孢呋辛钠
minoxidil - 米诺地尔
galanthamine - 加兰他敏
clobetasol - 丙酸氯倍他索
paw - 爪
tramadol - 曲马朵
tretinoin - 维甲酸
vinpocetine - 长春西汀
perilymph - 淋巴液
phenacetin - 非那西丁
usp - 美国药典
poloxamer - 泊洛沙姆
licking - 舔
narcotic - 麻醉药品
pharmacy - 药学的
piroxicam - 吡罗昔康
zopiclone - 佐匹克隆
chlorzoxazone - 氯唑沙宗
aminopyrine - 氨基比林
cefotaxime - 用头孢噻肟
flurbiprofen - 氟比洛芬
prodrug - 前体药物
perilymph - 外淋巴液
narcotics - 麻醉药品
dipivoxil - 福韦酯
pharmaceutics - 药剂学
expiry - 有效期
ointment - 软膏剂
irritability - 刺激性
dispensing - 调剂
excipient - 辅料
tdm - 治疗药物监测
clarity - 澄明度
barbital - 巴比妥
antihistamine - 抗组胺药
gels - 凝胶剂
zolpidem - 唑吡坦
openers - 开放剂
mycophenolic - 麦考酚
zidovudine - 齐多夫定
hypoglycemic - 降血糖药
berbamine - 盐酸小檗胺
paint - 涂剂
etodolac - 依托度酸
cream - 乳膏剂
chromatographed - 色谱
ddd - 限定日剂量
toxicokinetics - 毒代动力学
ribavirin - 三氮唑核苷
spermicidal - 杀精
synaptosomes - 突触体内
ddb - 联苯双酯
disintegration - 崩解时限
cefuroxime - 用头孢呋辛
antagonist - 拮抗药
glipizide - 格列吡嗪片
dispensary - 药房
antidepressants - 抗抑郁剂
chlorin - 二氢卟吩
suspensions - 混悬剂
microsphere - 微栓
bepridil - 苄普地尔
chlorzoxazone - 氯唑沙宗片
disintegration - 崩解度
antihistamines - 抗组胺药
antidiabetic - 抗糖尿病药
permeation - 渗透作用
bioassay - 生物检定
tenoxicam - 替诺昔康
aclacinomycin - 阿克拉霉素a
incompatibility - 配伍禁忌
grapefruit - 葡萄柚
anticoagulant - 抗凝血药
protopine - 普鲁托品
hyclate - 多西环素
macrolide - 大环内酯
triprolidine - 盐酸曲普利啶
aerosols - 气雾剂
guaifenesin - 愈创木酚甘油醚
ranolazine - 雷诺嗪
folinate - 用亚叶酸
terfenadine - 特非那定
ethacridine - 乳酸依沙吖啶
mucilage - 胶浆
macrolides - 大环内酯类药物
demethylase - 脱甲基酶
phenobarbitone - 苯巴比妥
hepatotoxicity - 肝脏毒性
ototoxicity - 耳蜗毒性
memantine - 美金胺
protopine - 普罗托品
clenbuterol - 氨哮素
nefopam - 平痛新
microdialysis - 微渗析
flucloxacillin - 氟氯西林
carbapenems - 碳青霉烯类抗生素
loperamide - 洛哌丁胺
pharmaceutical - 药学的
creams - 乳膏
vd - 表观分布容积
antithrombotic - 抗血栓药
guanylyl - 鸟苷酸
prophylactic - 预防用药
pregnane - 孕烷
antihistamine - 抗组胺
gargle - 含漱剂
amodiaquine - 阿莫地喹
lipoxygenase - 脂加氧酶
floxuridine - 氟尿苷
polymorphs - 多晶型
netilmicin - 乙基西梭霉素
cloxacillin - 邻氯青霉素
hplc-uv - 高效液相色谱-紫外
antifungal - 抗真菌的
muscarinic - 毒蕈碱样
prednisolone - 氢化泼尼松
antibiotics - 抗生素s
tetramethylpyrazine - 四甲基吡嗪
pharmacy - 药剂学
wortmannin - 渥曼青霉素
reinfusion - 再灌注
nime - 国产
pivoxil - 匹酯
staphylokinase - 葡萄球菌激酶
xylazine - 赛拉嗪
metoprolol - 甲氧乙心安
antitussive - 镇咳药
tad - 泰特
submicron - 亚微粒
celiprolol - 塞利洛尔片
fosfomycin - 用磷霉素
cpp - cpp效应
sensitizers - 增敏剂
noninterference - 不干扰
triamterene - 氨苯蝶啶
spm - 螺旋霉素
taurine - 氨基乙磺酸
pefloxacin - 甲氟哌酸
luteolin - 藤黄菌素
gelling - 胶化
guaifenesin - 愈创甘油醚
digitoxin - 洋地黄毒甙
valerate - 戊酸酯
gyrase - 回旋酶
lysostaphin - 溶葡萄球菌酶
phenothiazine - 吩噻嗪类
sulbactam - 舒巴克坦
hplc-dad - 高效液相色谱
hplc-uv - 高效液相色谱法
nmda - 氨基酸nmda
moxicillin - 阿莫西林
glycinate - 甘氨酸酯
poultice - 巴布剂
ethylamino - 乙氨基
convulsant - 惊厥剂
fungus - 菌物
otic - 滴耳
overdose - 超剂量
otic - 耳用
counteraction - 拮抗作用
cytokines - 细胞因子类
lotio - 洗剂
elixir - 酏剂
lpc - lpc引起
tegafur - 喃氟啶
benzamide - 苯酰胺类
esculin - 七叶苷
workmen - 男工
kazakstan - 哈萨克族
incubates - 共孵育
flunarizine - 氟苯桂嗪
trenbolone - 群勃龙
addenda - 附录
bacteroid - 拟杆菌
agglutination - 凝聚作用
microcapsules - 微囊剂
limes - 限量
decarboxylation - 脱羧基
tab - 片剂
maca - 马卡
aglycone - 糖苷配基
spirone - 螺内酯
edibility - 食用价值
cartose - 葡萄糖
zopiclone - 右旋佐匹克隆
propofol-induced - 丙泊酚
mucilage - 胶浆剂
uv-vis - 紫外分光光度法
trypanosoma - 锥体虫
illegitimate - 不合理的
rhythmicity - 自律性
rp-hplc - 反相-高效液相色谱法
multivitamins - 多维
gliquidone - 格列喹酮片
secretase - 分泌酶
friedel - 付
phototoxic - 光毒性
tunicamycin - 地衣霉素
electroosmosis - 电渗作用
orchis - 睾丸
azine - 吖嗪
indolyl - 吲哚基
antipyretic - 解热药
toxicokinetics - 毒动学
multi-variation - 多元
thymosin - 胸腺激素
thiabendazole - 噻苯唑
hct - hct
hydroxyvitamin - 羟维生素
organizer - 组织导体
ditto - 同上
androstenedione - 雄甾烯二酮
emul - 乳剂
rast - 放射变应原吸附试验
floc - 絮状沉淀
pellet - 小丸
ingredent - 成分
promazine - 丙嗪
ctp - 胞苷三磷酸
microassay - 微量测定
pulvis - 冲剂
syrupus - 糖浆
uva - 紫外线a
dehydroepiandrosterone - 脱氢表雄甾酮
scruff - 颈背
pharmacy - 配药
hydroxyvitamin - 维生素
overproduction - 过量生成
agmatine - 精胺
labetalol - 盐酸拉贝洛尔
sotalol - 甲磺胺心定
incompatibility - 药物配伍禁忌
episiotomy - 会阴切开术
antacids - 抗酸药
antacid - 抗酸药
acetoacetate - 乙酰乙酸酯
mycotic - 真菌病的
hplc-dad - 高效液相色谱-二极管阵列检测器
edta - 乙二胺四醋酸
pramipexole - 普拉克索
dandruff - 皮脂溢性皮炎
