通用高频词汇百科

undergraduate - 本科
the Double Ninth Festival;Chongyang Festival - 重阳节
hukou; Household Registration System - 户口
expert - 达人
dumbfounded; embarrassed - 囧
Pure Bright Festival; Tomb Sweeping Day; Qingming Festival - 清明节
5-fluorouracil - 5－氟尿嘧啶
Popular Issues;hot spots;hotspot;Hot Topic;focal points - 研究热点
morning dew - 朝露
transpositonal consideration；stand in one’s shoes - 换位思考
Double-Seventh Day；The Double Seventh Festival - 乞巧节；七夕乞巧；七夕节；女儿节
The Spring Festival; Chinese New Year - 春节
publicize budget - 公开预算
disposable dishware - 一次性餐具
commercial exploitation - 商业炒作
Lantern Festival - 元宵节
world ball - 世界波
auto show - 车展
water scarcity - 水荒
guanggun - 光棍
tuhao - 土豪
promoted team - 升班马
Integrated Hospital Information System - 医院信息系统
High Technology - 高技术
Enhanced Versatile Disk， - 增强型多媒体盘片系统
Digital TV - 数字电视
Digital Versatile Disk， - 多功能数码光盘
Micro Electro-Mechanical Systems - 微机电系统
Liquid Crystal Display - 液晶显示器
Research Interests; Focal Interests - 研究兴趣
Multi-acid Chemistry - 多酸化学
dama - 大妈
low-rent house - 廉租房
state owned enterprises - 国有企业
basic medical insurance - 基本医疗保险
reality show - 真人秀
hunk - 肌肉男
knock-off - 山寨
Recreational Vehicle - 房车
avant-garde - 前卫
copycat - 山寨
behind-the-scenes - 幕后
hide-and-seek - 躲猫猫
excessive liquidity - 流动性过剩
parody - 恶搞
zero-sum game - 零和博弈
Screw up - 搞砸
public hearing - 听证会
cougar - 熟女
downfall  - 坠落,落下,没落,灭亡,大下特下,陷阱之一种,
surveillance plane - 侦察飞机
survival rate - 成活率
suspected case - 疑似病例
sustainable development - 可持续发展
State Councilor - 国务委员
State Taxation Administration - 国家税务总局
state visit - 国事访问
statistician - 统计师
steering committee - 筹划指导委员会
stimulants - 兴奋剂
stock of capital - 存量资本
storage capacity - 存储能力
Storekeeper - 仓库管理员
stowaway - 偷渡者
strategy of sustainable development - 可持续发展战略
spaghetti - 意大利粉
spare parts - 备件
Spark Program - 星火计划
special administrative region - 特别行政区
Spokesman - 发言人
spoof - 恶搞
spot check - 飞行药检
spot check - 抽检
spot transaction - 现货交易
stabilize prices - 稳定物价
Stage Manager - 舞台监督
stall - 排档
stand up - 放鸽子
standard mandarin - 标准普通话
Standing Committee - 常务委员会
standing committee - 常委会
start from scratch - 从零开始
start-up - 创业者
State Administration of Radio, Film and Television - 国家广播电影电视总局
State Economic and Trade Commission - 国家经济贸易委员会
State Environmental Protection Administration - 国家环境保护总局
State Environmental Protection Administration - 国家环保总局
Sino-foreign joint venture - 中外合资企业
slow-motion - 慢镜头
social security system - 社会保障制度
soft science - 软科学
soil erosion - 水土流失
soilless cultivation - 无土栽培
solvency - 偿付能力
South-to-North water diversion project - 南水北调工程
sovereign immunity - 主权豁免
space station - 太空站
space walks - 太空行走
spacecraft - 航天器
Special Treatment - ST股；特别处理股
the multilateral trading system - 多边贸易体制
The Lantern Festival - 元宵节
the investment subject - 投资主体
the international community - 国际社会
Tibetology - 藏学
three-dimensional agriculture - 立体农业
thermal pollution - 热污染
therapeutic massage - 保健按摩
The TRUE Story of Ah Q - 《阿Q正传》
the Sunday Times - 星期日泰晤士报
The Romance of the Three Kingdoms - 《三国演义》
the real economy - 实体经济
the primary stage of socialism - 社会主义初级阶段
the press - 报界
transfer payment - 转移支付
transfer of knowledge - 知识转让
traditional opera - 戏曲
traditional Chinese medicine - 中药
trade war - 贸易战
trade protectionism - 贸易壁垒
tradable share - 流通股
township enterprises - 乡镇企业
toss - 掷钱猜先
Torch Plan - 火炬计划
top student - 高材生
top notch - 大腕
Tomcat - 野猫战斗机
to be listed - 上市
three wastes(waste gas, waste water and waste residues) - 三废(废气、废水、废渣）
three shifts - 三班倒
Three Gorges Project - 三峡工程
underground nuclear test - 地下核试验
Uncle Sam - 山姆大叔
unauthorized collection of fees by educational institutions - 教育乱收费
UN peacekeeping operations - 联合国维和行动
ultrashort wave - 超短波
tycoon - 大款
turnover rate - 换手率
trolley bus - 无轨电车
travel allowance - 交通补助
transparency - 透明度
transnational corporation - 跨国公司
transient population - 流动人口
tower - 塔楼
touchscreen - 触摸屏
variety show - 综艺节目
value engineering - 价值工程
USB drive - U（优）盘
Uruguay Round - 乌拉圭回合
urban per capita disposable income - 城镇居民人均可支配收入
exclamation - 惊叹号
period - 句号
comma - 逗号
apostrophe - 省略号；所有格符号
hyphen - 连字符
dash - 破折号
parentheses - 圆括号
ditto - 同上
El Nino - 厄尔尼诺
carry forward the fine traditions - 发扬优良传统
anti-dumping - 反倾销
basic education - 基础教育
time-rate wage system - 计时工资制
technological innovation - 技术创新
zebra crossing - 斑马线
yoga - 瑜迦
Yasukuni Shrine - 靖国神社
English-Chinese Dictionary - 英汉双解词典
aileron - 副翼
Security Council - 安理会
Securities and Exchange Commission - 证券交易委员会
search engine - 搜索引擎(计算机)
scooter - 滑板车
scoop - 独家新闻
scale merit - 规模效益
sauna - 桑拿浴
satellite town - 卫星城
satellite communication - 卫星通讯
SARS case - 非典病例
sample survey - 抽样调查
salvage ship - 海上救助船
Sales Manager - 销售部经理
share capital - 股本
Shangri-la - 香格里拉
sexually transmitted disease - 性病
sex education - 性教育
sense of ownership - 主人翁精神
senior lecturer - 高级讲师
senior engineer - 高级实验师
senior economist - 高级经济师
senior agronomist - 高级农艺师
Senior Accountant - 高级会计师
semifinals - 半决赛
sell-off - 处理存货
sell well - 走俏
seize the opportunity - 抓住机遇
Section Chief - 工段长
Secretariat - 秘书处
Secretarial Pool - 秘书室
secret ballot - 不记名投票
deice  - 防止结冰,除冰,装以除冰装置,
deliberate  - 深思熟虑的,故意的,有计划的,慎重的,不慌忙的,从容的,谨慎的,磋,商讨,
demise  - 崩,薨,死亡,让渡,遗赠,转让,
directorial  - 指挥的,管理的,指挥者的,
disappear  - 看不见,失纵,消没,消失,消灭,失纵,消失,不见了,遁,杳,
disarray  - 弄乱,使混乱,使脱去衣服,无秩序,杂乱,不整齐的衣服,
disaster  - 灾害,惨事,天灾,不幸,倒霉运,祸,难,灾,灾难,
discourage  - 使沮丧,使丧失勇气,使打断念头,阻止,使受挫折,气馁,
discretion  - 慎重,辨别力,考虑,判断,识别,判断的自由,自由裁量,斟酌,自由裁决,
disdain  - 轻蔑,侮蔑,骄傲自大,藐视,不屑做...,以...为耻而不做,使退下,鄙弃,鄙视,
disease  - 病,不健全,弊病,变质,使害病,疾病,病症,疾,症,
disguise  - 变装,假装服,虚伪,托辞,欺骗,伪装,化装,隐藏,装模作样,
disgusted  - **,
disk  - 平圆盘,圆盘,唱片,圆盘状组织,花盘,磁碟,
cognition  - 认识,认识力,知觉,
collateral  - 并行的,附随的,旁系的,支亲,副保,附属担保物,
collator  - 对照者,校对者,整理人,
coloured  - 有彩色的,有色的,装饰的,
colt  - 小马,无经验的年轻人,新手,苔绳,用鞭绳抽打,驹,
combined  - 化合的,综合的,组合的,
comely  - 标致的,美丽的,不会丢脸的,适宜的,合适的,满意的,
comfort  - 慰藉,慰劳品,舒适,使生活舒适,被窝,帮助,安慰,使缓和,使快乐,
comical  - 滑稽的,好笑的,诙谐的,奇妙的,滑,滑稽,
coming  - 就要来的,将来的,其次的,新进的,渐露头角的,到达,发生,来临,未来,
commander  - 指挥官,司令官,海军中校,副舰长,上级勋爵,舰长,
commentary  - 注释,评论,批评,时事评论,实况录音记录,评注,
commission  - 委任状,命令,委员会,代办,任命,订制,任命为军官,使服役,佣金,
commissioner  - 委员,理事,局长,行政长官,地方行政官,职业棒球等的最高负责人,
commonplace  - 平凡的,陈腐的,老生常谈,陈腐之言,日常琐事,备忘录,记入备忘录,平凡,普遍,
communicate  - 传,传达,使改感染,给予圣餐,沟通,相通,通信,传染,接受圣餐,
comparative  - 比较的,由于比较的,比较上的,相当的,比较级的,比较级,
compassionate  - 慈,慈悲的,富于同情心的,斟酌情况的,怜悯,同情,
competition  - 满足的,安份的,甘心的,比赛,竞争,赛,
complement  - 补充物,补语,馀数,补充,补足音程,全数,规定人数,补助,附加物,
complex  - 复杂的,合成的,复句的,复杂的事物,复合,复句,固定观念,复合的,复杂,
complexion  - 面色,肤色,外观,情况,局面,性质,气色,形势,脸色,
composedly  - 镇定地,沉着地,自若地,
con  - 精读,学习,默记,反对地,从反面,欺诈的,反对者,反对票,肺病,
contemptuous  - 轻蔑的,傲慢的,愚弄人的,瞧不起人的,轻视的,轻视,
contention  - 争,争斗,竞争,争论,论战,争论点,主张,动词为,冲突,
contest  - 竞争,斗争,争论,论战,竞赛,竞技,竞演,争取,争夺,
contingent  - 队伍,或许发生的,附随的,暂时的,偶然的事情,分遣队,
continuance  - 永续,持续,继续,连续,续篇,改期续询,
contradict  - 反驳,反对,抗辩,否认,矛盾,背驰,相反,抵触,驳,
contribute  - 奉赠,捐赠,投稿,寄稿,贡献,赠送,资助,成为因素,缴纳,
convenient  - 便利的,合宜的,附近的,简便的,方便的,便,便当,便利,方便,
Converse  - 相反的事物,倒,逆向,相反的,逆向的,颠倒的,交谈,谈话,认识,
conversion  - 变换,换位,转向,改党,心理的转变,强占,换算法,兑换,转换,
converter  - 变换设备,变流器,转换器,
conveyor  - 运送器,运送者,转运带,
people-oriented service - 人性化服务
multinational companies - 多（跨）国公司
multimedia - 多媒体
mouthpiece - 喉舌；代言人
Mount Qomolangma - 珠穆朗玛峰
morning market - 头市
morning exercise - 晨练
moral education - 品德教育
Monroe Doctrine - 门罗主义
money-oriented - 一切向钱看
monetization - 货币化
module - 模块
modern thinking - 现代意识
modern distance education - 现代远程教育
preparatory committee - 筹备委员会
premium - 溢价
portals - 门户网站
portal - 门户网站
population density - 人口密度
popularity - 人气
pop culture - 流行文化
pop can - 易拉罐
political restructuring - 政治体制改革
pinko - 左倾
pilot project - 试点工程；试点项目
pilot project - 试点工程
pillar - 支柱产业
philosophy of life - 处世之道
pharmacist - 主管药师
pharmacist - 药师
perihelion - 近日点
percentage points - 百分点
professional evaluation - 评职
principle of equality and mutual benefit - 平等互利原则
Prince Charming - 白马王子
primary productive force - 第一生产力
price fluctuation - 价格波动
price elasticity - 价格弹性
pretty pass - 尴尬，困境，糟糕
press box - 记者席
Presidium - 主席团
President - 总裁
President - 理事长
preschool education - 学前教育
premarital cohabitation - 婚前同居
preferential tax policies - 优惠的税收政策
preferential duty - 优惠关税
prayer wheel - 转经筒
powerball - 强力球(美国的全国性彩票)
power shot - 劲射
Development - 试验发展
Audience segmentation - 受众分割
Digital Earth - 数字地球
Grid Computing - 网格计算
Network Database - 网络数据库
Crisis Management - 危机管理
liquid crystal - 液晶
veto power - 一票否决权
Telemedicine - 远程医学
Manned Space Flight - 载人航天
manned spaceflight - 载人航天
The Knowledge Economy - 知识经济
Liposome - 脂质体
Autonomic Computing - 自主计算
Comprehensive Security - 综合性安全或非传统安全
3rd Generation - 3G
Computer Graphics - CG
Dioxin - “二恶英”
semiconductor material - 半导体材料
Electronic Cash - 电子现金
abluent - 洗洁剂
ablution - 清洗
ably - 能干地
ABM - 反导弹
abnormality - 反常
abnormally - 反常地
abnormity - 异常
aboveground - 在地上
above-mentioned - 上述的
abrade - 磨损
Abraham - 亚伯拉罕
abranchial - 无鳃的
abrasion - 擦破
abrasive - 磨损的
abraxas - 避邪字
abreact - 消散
abreast - 并肩地
abri - 避难所
abridge - 剥夺
abridged - 省略的
abridgement - 删节
abroad - 往国外
abrogate - 废除
abrogation - 废除
abrupt - 突然的
abruption - 中断
abruptly - 突然地
abruptness - 突然
abscessed - 长脓疮的
ALGOL - Algol语言
Domain  - 领土,版图,领域,范围,专业,专长,
dominant  - 支配的,有力的,优势的,高耸的,优性的,属音的,支配的事物,属音,优势,
dominator  - 支配者,统治者,支配力,
dental  - 齿的,牙科的,齿音的,齿音,牙齿的,牙齿,
department  - 部分,部门,处,局,部,系,县,军管区,科系,
depend  - 靠,凭,依赖,信任,下垂,悬,悬而未定,从属,依靠,
deplore  - 悲叹,悲悼,感到遗憾,后悔,悔恨,悲痛,
deployment  - 部署,配置,展开,
deputy  - 代理人,代理,副...,议员,代议士,副的,帮办,副,丞,
describe  - 记述,叙述,描写,描绘,制图,作运行,描述,摹画,形容,
designate  - 示,指出,指定,命名,任命,赋予番号,指派的,受命但尚未就任的,指名,
designation  - 指示,指定,指名,
desktop  - 桌面,桌上型,桌面管理系统程序,
despise  - 轻视,蔑视,藐视,瞧不起,薄,鄙薄,鄙视,不齿,藐,
despite  - 轻视,蔑视,恶意,怨恨,侮辱,不顾,不管,尽管,任凭,
Detail  - 细节,详情,详述,选派,画详图,详细数据,
detract  - 减损,贬低,转移,
devote  - 献,供献,听任,充任,专用于,奉献,
devoted  - 忠实的,献身的,埋头于,献身于,忠诚的,忠诚,
dew  - 露,玉,小粒珠,爽快,新鲜味,未经世故,用露水沾湿,结露,露水,
dewy  - 露湿的,带露水的,如露的,爽快的,带露的,带露,
dexterity  - 机巧,灵巧,机敏,精明周到,用惯右手的人,灵活的,
diagnostic  - 诊断的,诊断上有价值的,特征的,诊断,病的征候,诊断法,
dial  - 号码盘,标度盘,指针盘,日晷仪,矿坑缴针仪,拨电话号码,以标度盘表示,拨号,表盘,
dicker  - 十个,十张,小生意,做小生意,易货,还价,
dictate  - 听写,口述,口授,命令,指令,指挥,
dictation  - 口述,口授,听写,命令,指令,指挥,
dignified  - 崇,端庄,俨,俨然,有威严的,有品格的,
diminutive  - 小的,小型的,指小的,表示小的,小的人,指小辞,昵称,亲爱形,爱称,
dink  - 漂亮的,打扮,装饰,
dinky  - 极小的,不足道的,整洁的,
dip  - 浸一下,把蕊浸入蜡中以制造,汲出,潜出,掏出,降,浸,浸液,弛度,
DIP  - 双排直插封装,浸,下降,倾斜,舀取,双式直插式封装,
diplomatic  - 外交关系的,有外交手腕的,富于策略的,研究古文书的,古文书学,外交的,外交手腕的,外交,外交手腕,
dote  - 溺爱,昏聩,智力衰退,
douse  - 插入水中,弄湿,把弄熄,放松,浸泡,泼洒,
downfall  - 坠落,落下,没落,灭亡,大下特下,陷阱之一种,
downright  - 明白的,率直的,显明的,全然,彻底,完全,
drainage  - 排水,放水,排水方法,排水渠,下水道,排水区域,流域,排出的水,排脓,
draught  - 气流,草稿,汇票,通风,拉,牵引,起草,征兵,选派,
dread  - 非常害怕,忧虑,恐怖,畏敬,恐怖的事物,可畏惧的,庄严的,惮,恐惧,
dreg  - 渣滓,沉淀物,糟粕,
drench  - 使湿透,使浸透,灌药水,湿透,倾盆大雨,药水,
driver  - 驱逐员,司机,驾驶员,工头,动轮,动力传导部门,最常打用的木头球杆,驾驶者,开车人,
driving  - 赶,操纵,驾驶,推进的,强劲的,精力旺盛的,
drizzle  - 毛毛雨,蒙,溟,霎,细雨,下毛毛雨,
dub  - 配音,轻点,授予称号,打击,一下击鼓声,笨蛋,
duchy  - 公爵领地,公国,直辖领地,
dummy  - 虚拟的,假的,虚构的,傀儡,假人,哑巴,
dump  - 抛下,倾销,移送国外,砰地落下来,抛售,垃圾场,临时堆积处,粗短,抛弃,
enormous  - 非常大的,巨大的,庞大的,无法无天的,极大的,极大,巨大,庞,庞大,
enterokinase  - 肠激酶,肠致活酶,中肠酶,
enthusiastic  - 热心的,热诚的,狂信的,热心地,热狂地,热忱的,热忱,热情,热心,
envelope  - 信封,封套,封袋,外皮,气囊,函,
epidemic  - 传染病,流行,风行,传染性的,流行的,流行病,瘟,瘟疫,疫,
equip  - 准备,预备,装备,装备船只,授与,装置,
equity  - 公平,正当,衡平法,剩馀财产纯粹价额,演员协会,对等,
era  - 纪元,年代,时代,时期,...代,...纪,代,纪,世,
eraser  - 涂消者,消字迹用具,橡皮擦,墨水擦,黑板擦,橡皮搽,
ether  - 大气之外的空间,蓝天,大气,以太,醚,乙太,
ethics  - 伦理学,伦理,伦理学书籍,道德,道义,德,
ethnical  - 人种的,民族的,种族的,
eukaryon  - 真核,真核生物,真核细胞,
evangel  - 福音,佳音,主义,
evaporation  - 蒸发,气化,乾躁,脱水,蒸气,消散,
evenly  - 平衡地,平坦地,平等地,公平地,相等地,平静地,
exalt  - 提高,擢升,使普升,极力称赞,捧,使强烈,
examination  - 检查,审查,调查,斟酌,考试,考绩,诊察,审问,试,
break the deadlock - 打破僵局
brain drain - 智囊流失
brain drain - 人才流失
box office - 票房
bowling - 保龄球
bottom line - 底线
bottleneck - 瓶颈
block - 起跑器
blind date - 相亲
black whistle - 黑哨
bite off more than one can chew - 贪多嚼不烂
birth rate - 人口出生率
bird flu - 禽流感
bioterrorism - 生物恐怖主义
biosphere - 生物圈
biological engineering - 生物工程
democratic centralism - 民主集中制
central business district (CBD) - 中央商务区
census - 人口普查
capital market - 资本市场
capital flight - 资本外逃
capital allocation - 资金划拨
capital adequacy ratio - 资本充足率
capacity to earn foreign exchange through exports - 出口创汇能力
canopy - 华盖
campus culture - 校园文化
Cameraman - 摄影师
caller ID - 来电显示
call forwarding - 呼叫转移
cable television - 有线电视
by-election - 补缺选举
buy into - 入股
entrepreneurial - 创业
porter - 波特
incentives - 激励
appraisal - 考评
mnc - 跨国公司
chain - 链合
budgeting - 预算
diversification - 多元化经营
competitors - 对手
entrepreneurship - 创业
entrepreneurial - 企业家
loyalty - 忠诚度
leverage - 杠杆
privately - 民营
bullwhip - 牛鞭
distress - 困境
partners - 合作伙伴
compensation - 报酬
drain - 流失
stakeholder - 利益相关者
chain - 链环
partner - 合作伙伴
competency - 能力
scorecard - 分卡
insider - 内部人
recruitment - 招聘
competency - 竞争力
list - 上市
acquisition - 收购
profitability - 盈利能力
vendor - 供应商
loyalty - 忠诚的
teams - 团队
equity - 产权
inventory - 存货
sigma - 西格玛
supervisors - 监事会
payment - 薪酬
theorists - 理论界
contingency - 权变
bullwhip - 长鞭
divestiture - 剥离
human - 人力
performance - 绩效
competitive - 竞争
company - 企业
innovation - 技术创新
corporate - 企业
governance - 治理
corporate - 公司
General Office of the State Council - 国务院办公厅
house purchasing - 置业
host the 2008 Olympic games - 主办2008年奥运会
horror film - 恐怖片
Hope Project - 希望工程
Honorary Chairman - 名誉董事长
ground crew - 地勤人员
gross national product (GNP) - 国民生产总值
gross domestic product (GDP) - 国内生产总值
grocery store - 小卖部
greenhouse gases - 温室气体
green card - 绿卡
green bank - 绿色银行
graduation design - 毕业设计
Governor - 省长
government procurement - 政府采购
group technology - 成组技术
group psychology - 从众心理
infant industries - 幼稚产业
income tax - 所得税
income gap - 收入差距
income from property - 产权收益
inbound tourism - 入境旅游
inbound tourism - 国内游
in turn - 轮流（坐庄）
in place - 到位
hydrogen bomb - 氢弹
human genome - 人类基因图谱
human communication - 人际交往
household service - 家政服务
high definition - 高清晰度
high consumption - 高消费
hidden danger - 隐患
handle cases impartially - 秉公办案
hammer - 大力扣杀
Hamas - 伊斯兰抵抗运动，简称
hairdressing salon - 发屋
hacker - 黑客
guarantee period - 保质期
industrial stock - 工业股票
industrial park - 工业园区
industrial and commercial bureau - 工商局
individually-run enterprises - 民营企业
issue price - 发行价格
home page - 主页
Home owner - 业主
Hollywood blockbuster - 好莱坞大片
hit through - 抽杀成功
hiring preference - 优先安置
hip-hop - 街舞
deliberate - 深思熟虑
duly - 适时地
repurchase - 购回
usurp - 篡夺
marketers - 营销人员
vesting - 授予
outs - 收购
collect - 收款
overwhelming - 势不可挡的
employ - 雇用
rumor - 传闻
redound - 回报
apt - 恰当的
informative - 情报的
congratulations - 贺词
balks - 障碍
subscribe - 认购
empowering - 分权
divestiture - 资产剥离
buyouts - 收购
salary - 薪资
dell - 戴尔
privately-run - 民营
eps - 每股收益
benchmarking - 标杆
leadership - 领导力
prise - 企业
inspiriting - 激励
refinancing - 再融资
payable - 应付
deferred - 递延
private-owned - 私营
counterintelligence - 反竞争情报
leverage - 杠杆率
governs - 治理
citroen - 雪铁龙
administers - 治理
reward - 奖金
motorola - 摩托罗拉公司
buyout - 杠杆收购
discounting - 贴现
opportunist - 机会主义
entrepreneurship - 企业家能力
tacit - 意会
chandler - 钱德勒
impairments - 减值
forethought - 先见
teamwork - 团队合作
confederation - 联盟
amalgamation - 企业合并
insolation  - 日晒,晒干,中暑,
inspiration  - 灵感,巧思,激励,给予激励的人,指示,教示,神灵的感召,吸入,吸气,
instruction  - 教授,教导,教育,知识,通告,训令,指示,训,指令,
insult  - 侮辱,无礼,无礼对待,曼,辱,侮,
insure  - 接受保险,保险,投保,确保,保证,使确定,
insurrection  - 叛乱,暴动,作乱,
integrate  - 综合,使结合,使成整体,成一体,完整的,完全的,
intellect  - 智力,智能,理解力,思维能力,知识份子,识者,
intelligent  - 智能高的,贤明的,有才能的,有理解的,聪,聪明,懂事,慧,智能,
intercourse  - 交际,交通,交换意见,灵交,交接,性交,
intergrade  - 中间等级,过渡阶级,逐渐合一,
interlocutory  - 对话的,对话体的,中间的,
Intermediate  - 中级,中间物,调停者,中间的,中级的,起媒介作用,
internecine  - 互相残杀的,两败俱伤的,致命的,
interpose  - 放入,插入,提议,介入,干涉,插嘴,
interrelate  - (使)相互关连,
intervene  - 插入,插进,介于其间,中间发生干扰,干涉,介入,调停,参加诉讼,干预,
introduce  - 引导,投入,给与初次经验,传授,介绍,使进入社交界,提议,倡,介,
intrude  - 塞入,挤入,迸入,强使,迫使,闯入,侵入,多管闲事,干扰,
invade  - 侵扰,侵略,闯入,蜂拥而上,袭击,袭来,侵犯,入侵,宰割,
invitation  - 招待,邀请,请帖,邀请书,劝诱,魅力,
invite  - 邀请,劝诱,恳请,惹起,招致,发生,魅惑,诱惑,请帖,
invited  - 邀请,引起,招致,
iron  - 铁,制铁工具,熨斗,手枪,强壮,坚强的,坚忍不拔的,残酷的,上手拷,
irradiation  - 发光,放射,照射,
irresolute  - 踌躇,徊,徘,旁,俳,彷,徨,憧,蹰,
ISDN  - 整体服务数位网路,整体数位服务网路,综合服务数位网络,
island  - 岛,岛状物,安全岛,月台,司令塔,使孤立,使散布如岛屿,岛屿,洲,
ivory  - 象牙,象牙质,象牙色,牙齿,象牙镶嵌,骰子,钢琴的键盘,象牙的,牙,
Ja -  ,一月
jack  - 男人,年轻人,杂工,水手,起重机,烤肉架,捕鱼灯,顶起,小起重机,
Japanese  - 日本,倭,日本的,日本人的,日本人,日语,
hector  - 栌辱,威吓,作威作福,
helmet  - 盔,钢盔,消防盔,盔帽,盔甲,胄,
hence  - 由是,因此,今后,从此,今世起,!出去!,
hereditary  - 世袭的,世代相传的,继承关系的,由于遗传的,遗传的,遗传,
hermit  - 行者,隐士,隐居者,胡桃,萝卜乾等制成的糖果,蜂雀,
heroism  - 英雄的气质,勇壮,豪勇,忠烈,英雄的行为,英勇的行为,
hesitate  - 迟疑,踌躇,犹豫不定,支吾其辞,吞吞吐吐,犹豫,踌,躇,趄,
heterogeneous  - 驳杂,多相,异质,异种的,异质的,由不同成分形成的,
hey  - 表示惊,喜,疑虑,促使注意的喊声,!喂!计程车!,喂,哎,哎哟,嘿,
highlight  - 突出,加亮区,精彩场面,加亮,使显著,以强光照射,
highway  - 大道,公路,主要交通线,高速公路,冲,坦白途,
hindrance  - 妨碍,障碍,阻力,
hip  - 臀部,屁股,腰骨,基节,隅栋,玫瑰,忧郁,忧愁,喝采欢呼声,
hiss  - 发出嘶嘶声,发虚声制止,虚声,嘶嘶声,叱责声,蛇等发出的声音,嘘声,嘶,嘘,
hitherto  - 迄今,到此,至今,
hoar  - 白的,灰色的,发白的,灰白,灰白色,白霜,
hod  - 木制容器,煤斗,装木炭容器,
holdout  - 抵抗,坚持,支持,
professional title - 职称
production line - 生产线
product mix - 产品结构
Producer - 制片人
procuratorial organ - 检察机关
private school - 私塾
private capital - 民间资本
prioritize - 重点发展
plant community - 植物群落
planned economy - 计划经济
place of origin - 原产地
quadruple - 翻两番
Qinghai-Tibet Plateau - 青藏高原
put on airs - 摆架子
put - 看跌/看涨期权
purpose-made - 特制的
purified water - 纯净水
purchasing power parity - 购买力平价法
purchasing power - 购买力
puppy love - 早恋
punk - 朋克
punish severely - 严惩
publicity stunt - 做秀
protein engineering - 蛋白质工程
proprietary intellectual property rights - 自主知识产权
propose a toast - 举杯
propose a toast - 敬酒
recycled paper - 再生环保纸
recycled paper - 再生纸
recoverable reserves - 可采储量
Security Council - 安理会
Securities and Exchange Commission - 证券交易委员会
search engine - 搜索引擎(计算机)
scooter - 滑板车
scoop - 独家新闻
scale merit - 规模效益
sauna - 桑拿浴
satellite town - 卫星城
satellite communication - 卫星通讯
SARS case - 非典病例
sample survey - 抽样调查
salvage ship - 海上救助船
Sales Manager - 销售部经理
share capital - 股本
Shangri-la - 香格里拉
sexually transmitted disease - 性病
sex education - 性教育
sense of ownership - 主人翁精神
senior lecturer - 高级讲师
senior engineer - 高级实验师
inter-bank borrowing - 同业拆借
marginal return - 边际报酬
marginal benefit - 边际效益
margin account - 保证金帐户
make arrangements - 操办
make a fresh start - 另起炉灶
mainstay of the economy - 主体经济
mail-order service - 邮购服务
mail-order - 邮购
macro-control - 宏观调控
luxury car - 豪华轿车
low-cost housing - 经济房
Love me, love my dog. - 爱屋及乌
lottery ticket - 彩票
local war - 局部战争
local police station - 派出所
local calls - 市话
mass organizations - 各人民团体
mascot - 吉祥物
market-oriented - 以市场为导向
marketization - 市场化
marketing - 营销
marketing - 市场营销学
market regulation - 市场调节
market orientation - 市场导向
market on commission - 代销
market expansion - 扩容
management system - 经营责任制
male chauvinism - 男权主义思想
make hay while the sun shines - 莫失良机;趁热打铁
negative mentality - 逆反心理
negative growth - 负增长
Ministry of Personnel - 人事部
Ministry of Information Industry - 信息产业部
Ministry of Foreign Affairs - 外交部
Ministry of Finance - 财政部
Ministry of Education - 教育部
Ministry of Culture - 文化部
Ministry of Construction - 建设部
Ministry of Communications - 交通部
Ministry of Civil Affairs - 民政部
Ministry of Agriculture - 农业部
minister without portfolio - 不管部部长
mining right - 开采权
minibus - 小巴
mineral resources - 矿源
millennium bug - 千年问题、千年虫
military court - 军事法院
military confrontation - 军事对峙
militarily competent - 军事过硬
housing  - 供给住宅,避难所,住房,
hum  - 不哼气,以鼻音哼歌,好景气,嘴中细语,哼声,远方嘈杂声,喧哗,诈欺,哼,
humanitarian  - 人道主义者,博爱者,基督凡人论者,人道主义的,博爱的,相信基督为凡人的,
humour  - 幽默,诙谐,情绪,体液,使满足,迁就,
hundred  - 多数的,百数,百数的东西,一百的记号,百米赛跑,百元,百岁,百,一百,
hurricane  - 暴风,台风,激发,飓风,暴风骤雨,飓,
I  - 鄙人,我,吾,余,予,朕,冰冻,使成冰,用冰覆盖,
ice&nbspcream       - 冰淇淋
fifth  - 第五的,五分之一的,第五,五分之一,第五日,第五度,
fifty  - 五十,五十岁的,五十个的,许多的,五十个,五十岁,
filament  - 细丝,细线,单纤维,花丝,白热丝,丝状物,
finely  - 再见!再会!一路平安!,告别的,临别的,告别,离别,告别辞,
firmness  - 坚固,坚牢,坚定,不动,刚毅,坚固性,
first-line  - 第一线的,头等的,最重要的,
flagging  - 铺砌石板,铺石材料,石板路,下垂的,衰弱的,委顿的,
flank  - 侧部,腰窝肉,侧面,侧翼,侧堡,站在...的侧面,面临著...,侧边,腹部,
flare  - 闪光,怒气冲冠,燃烧,张开部份,摇泄,发出闪光,用闪光作信号,夸示,闪亮,
flare-up  - 火焰,光等的骤发,骤燃,
flat-footed  - 扁平足的,断然的,直截了当的,
flatly  - 断然,毅然,直截了当,
flexure  - 屈曲,弯曲部分,折缝,
flick  - 快速的轻打,轻打声,弹开,轻弹,轻轻拂去,忽然摇动,
flight  - 飞行,航程,追赶猎物,迁徙,奔放,射远竞赛,飞行小队,射击,航行,
flirt  - 调情取乐,忽然移动,玩弄,忽然弹出,用力摇动,轻浮的女人,急投,调戏,调情,
flounce  - 衣裙上的荷边装饰,挣扎,挣脱,饰以荷叶边,跳动,突然离去,
flounder  - 挣扎,折腾,挣扎著前进,著慌,一再失败,焦躁,辗转,比目鱼之类,比目鱼,
flour  - 面粉,小麦粉,粉,粉末,白面,面,
fluke  - 侥幸成功,锚爪,比目鱼,侥幸,倒霉,蛭,
flutter  - 用振翅击,飘动,仓惶失措,挥动,使慌张,跳动,打赌,摇晃,摆动,
fluxion  - 流动,不断的变化,转变,
french  - 法国的,法语的,法国人的,法国式的,法国语,法国人,
frenzy  - 使狂乱,使激怒,狂乱,狂怒,狂暴,热狂,
fresco  - 壁画,在新涂灰泥的墙壁上作的水彩画,作壁画于,
friday  - 星期五,...的忠仆,忠实的男佣,
fright  - 惊骇,可怕的东西,奇丑的人,非常奇怪的东西,使惊吓,使胆怯,
frighten  - 使骇怕,使吃惊,恐吓做...,突然骇怕,震惊,恫,
frisk  - 乱跳,欢闹,活跃,欢跃,蹦跳,轻摇,
frontier  - 国境,开拓与未开地之交界地方,边境,未知的领域,限界,边疆,边陲,裔,陲,
fruitless  - 不结果的,不长果实的,无子的,无效果的,无益的,不结果,
Full  - 全部,充满的,完全的,丰富的,完美的,丰满的,详尽的,完全地,整整,
funeral  - 葬礼,出殡行列,告别式,该做的事,讨厌的工作,埋葬的,葬礼用的,丧礼时的,丧,
furnace  - 熔矿炉,炉,火炉,暖气闭锁炉,灼热的地方,严格的锻链,
fury  - 激怒,热狂,猛烈,复仇三女神之一人,冤魂,泼妇,悍妇,忿怒,暴怒,
gab  - 饶舌,爱说话,多嘴,空谈,瞎扯,唠叨,
gaiety  - 愉快,快活,高兴,欢乐,狂欢,华美,
gale  - 强风,疾风,暴风,微风,薰风,狂喜,欢乐,爆发,杨梅科灌木,
gall  - 胆汁,苦味,憎恶,水彩用透明液体,五倍子,擦伤,使焦急,使怒,浸五倍子液,
gallery  - 看台,特别席,通俗趣味,回廊,画廊,摄影场,船尾展望台,坑道,长廊,
gammon  - 腌猪后腿,胡说,腌,欺骗,作假,胡说八道!,
gang  - 一群,匪帮,夥伴,运动相连串的一套机械,集体行动,集体袭击,组成一套,帮派,帮,
civil affair - 民政
circumvention - 规避
China Securities Regulatory Commission (CSRC) - 中国证券监督管理委员会
China Mobile - 中国移动通信公司
China Foundation for Poverty Alleviation - 中国扶贫基金会
child prodigy - 神童
chief justice - 大法官
chief judge - 庭长
Chief Judge - 审判长
complete monopoly - 完全垄断
competitive sports - 竞技体育
competitive products - 精品
competitive mechanism - 竞争机制
competitive election - 差额选举
competitive bidding - 竟标
compelling obligation - 不可推卸的责任
Commissioner - 特派员
commercialization - 商品化
commercial loan - 商业贷款
commercial lending - 经常性贷款
commercial invoice - 商业发票
club together - 凑份子
closing price - 收盘价
close down - 查封
Controller - 财务主管
contract with - 承包
contract to build - 承建
contact lenses - 隐形眼镜
consumption tax - 消费税
conceptualization - 构想
concept car - 概念车
computer virus - 电脑病毒
computer crime - 电脑犯罪
compulsory education - 义务教育
comprehensive utilization of waste materials - 废物综合利用
comprehensive treatment - 综合治理
composite index - 综合指数
complimentary ticket - 优待券
complex - 情结
completion ceremony - 竣工仪式
comparative literature - 比较文学
tally company - 理货公司
common security - 共同安全
common prosperity - 共同富裕
common interests - 共同利益
commodity economy - 商品经济
current address - 目前地址
[ ]square brackets - 方括号
Management Information System - 管理信息系统
Principles of Management - 管理学原理
aerodynamic - 空气动力
aerodynamics - 空气动力学
aerodynamically - 空气动力学地
aerodynamicist - 空气动力学者
aerostatic - 空气静力学的
air-cooling - 空气冷却法
airspeed - 空速
air-raid - 空袭的
airspace - 空域
airborne - 空运
airlift - 空运
amplifier - 扩音器
abuse - 滥用
aging - 老化
acrostic - 离合诗
altruistic - 利他的
altruism - 利他主义
allied - 联盟的
affiliation - 联系
alchemy - 炼金术
alchemic - 炼金术的
alchemical - 炼金术的
alchemist - 炼金术士
amativeness - 恋爱
amatory - 恋爱的
amphibious - 两栖的
aftergrowth - 两期农作物
amphoteric - 两性的
abut - 邻接
adjacency - 邻接
abutting - 邻接的
adjoining - 邻接的
adjacent - 邻近的
afflatus - 灵感
akela - 领队人
Americanization - 美国化
American - 美国人
accouterments - 军人配备
acquittal - 开释
advised - 考虑过的
adorable - 可爱的
adoptable - 可采用的
acceptability - 可接受
accredited - 可接受的
affirmably - 可肯定地
actionable - 可控告的
affable - 可亲的
amiably - 可亲地
advisable - 可取的
alienable - 可让与的
Fuel Ethanol - 燃料乙醇
the Main Force - 生力军
Nanoelectronics - 纳米电子学
Implementation date - 实施日期
Development and utilization - 开发和利用
adsorption - 吸附
Idle  - 空闲的,闲着的,懒散的,无所事事的,无效的虚度,空想,使空闲,懒散,空转,
idolization  - 偶像化,盲目的崇拜,醉心,
ignorant  - 不学无术的,无知的,愚昧的,外行的,侗,蒙,愚昧,倥,蚩,
ILL  - 有病的,不健康的,坏的,拙劣的,难以处理的,麻烦的,坏,不利地,不完全,
illegitimate  - 不法的,非嫡出的,庶生的,不合理的,不符合习惯的,非嫡出子,
illumination  - 使光耀,照明,灯饰,阐释,启发,启蒙,装饰,明亮度,亮度,
illuminative  - 照明的,启蒙的,装饰的,
illusion  - 幻觉,幻影,幻想,妄想,错误的观念,错觉,透明面纱,幻象,梦幻,
imminent  - 迫切的,紧急的,急迫的,逼近,即将来临的,即将来临,
impatience  - 无耐性,不耐,性急,暴躁,没有耐心,不耐烦,
impel  - 催促,逼迫,强迫,强使,推进,前进,
injunction  - 命令,指令,劝告,告诫,禁止命令,强制命令,
ink  - 墨水,印刷用油墨,墨汁,用墨水写,用墨水做记号,涂墨水,用墨水弄污,墨水儿,篇幅,
inly  - 在内,在心中,衷心地,
innermost  - 最里面的,最深处的,最深处,
inning  - 一局,发展的机会,好时机,执政时期,填平,开拓,
innumerable  - 数不清的,无数的,无限之多的,不计其数,不可胜数,无数,
insanity  - 疯狂,精神异状,疯狂或愚蠢的行为,精神错乱,蛊,痫,
inscription  - 题铭,碑文,铭刻,题辞,题字,题词,
insolation  - 日晒,晒干,中暑,
inspiration  - 灵感,巧思,激励,给予激励的人,指示,教示,神灵的感召,吸入,吸气,
instruction  - 教授,教导,教育,知识,通告,训令,指示,训,指令,
insult  - 侮辱,无礼,无礼对待,曼,辱,侮,
insure  - 接受保险,保险,投保,确保,保证,使确定,
insurrection  - 叛乱,暴动,作乱,
integrate  - 综合,使结合,使成整体,成一体,完整的,完全的,
intellect  - 智力,智能,理解力,思维能力,知识份子,识者,
intelligent  - 智能高的,贤明的,有才能的,有理解的,聪,聪明,懂事,慧,智能,
intercourse  - 交际,交通,交换意见,灵交,交接,性交,
intergrade  - 中间等级,过渡阶级,逐渐合一,
interlocutory  - 对话的,对话体的,中间的,
Intermediate  - 中级,中间物,调停者,中间的,中级的,起媒介作用,
internecine  - 互相残杀的,两败俱伤的,致命的,
interpose  - 放入,插入,提议,介入,干涉,插嘴,
interrelate  - (使)相互关连,
intervene  - 插入,插进,介于其间,中间发生干扰,干涉,介入,调停,参加诉讼,干预,
introduce  - 引导,投入,给与初次经验,传授,介绍,使进入社交界,提议,倡,介,
intrude  - 塞入,挤入,迸入,强使,迫使,闯入,侵入,多管闲事,干扰,
invade  - 侵扰,侵略,闯入,蜂拥而上,袭击,袭来,侵犯,入侵,宰割,
invitation  - 招待,邀请,请帖,邀请书,劝诱,魅力,
invite  - 邀请,劝诱,恳请,惹起,招致,发生,魅惑,诱惑,请帖,
invited  - 邀请,引起,招致,
iron  - 铁,制铁工具,熨斗,手枪,强壮,坚强的,坚忍不拔的,残酷的,上手拷,
irradiation  - 发光,放射,照射,
advertent - 注意的
ahold - 抓
allergist - 专科医师
absolutism - 专制主义
absolutist - 专制主义者
aba - 毛织物
abac - 算图
abaci - 算盘
aback - 向后地
abacus - 算盘
Abaddon - 地狱
abaft - 向船尾
abandon - 放弃
abandonment - 放弃
abas - 打倒
abase - 降低
abasement - 降低
abash - 使局促不安
abashed - 不安的
abatement - 消除
abattoir - 屠宰场
abaxial - 离轴的
abb - 横丝
Abba - 神父
abbe - 神父
abbess - 女修道院院长
abbey - 修道院
abbot - 修道院
abbr. - 缩写
abbreviate - 缩写
abbreviated - 简短的
abbreviation - 缩写
ABC - 美国广播公司
abdomen - 腹
abdominal - 腹部的
abducent - 向外扩展的
abduct - 诱拐
abjure - 发誓放弃
ablare - 喧闹的
ablate - 融化
ablation - 消融
ablative - 离格的
ablaze - 着火的
able - 能的
able-bodied - 强壮的
aftercare - 照顾调养
alphabetic - 照字母次序的
ail - 折磨
acus - 针
acupuncture - 针刺疗法
altruism - 利他主义
allied - 联盟的
affiliation - 联系
alchemy - 炼金术
alchemic - 炼金术的
alchemical - 炼金术的
alchemist - 炼金术士
amativeness - 恋爱
amatory - 恋爱的
amphibious - 两栖的
aftergrowth - 两期农作物
amphoteric - 两性的
abut - 邻接
adjacency - 邻接
abutting - 邻接的
adjoining - 邻接的
adjacent - 邻近的
afflatus - 灵感
akela - 领队人
Americanization - 美国化
American - 美国人
accouterments - 军人配备
acquittal - 开释
advised - 考虑过的
adorable - 可爱的
adoptable - 可采用的
acceptability - 可接受
accredited - 可接受的
affirmably - 可肯定地
actionable - 可控告的
affable - 可亲的
amiably - 可亲地
advisable - 可取的
alienable - 可让与的
alienability - 可让与性
admissibility - 可容许
admissible - 可容许的
addressable - 可设定地址的
accountably - 可说明地
amendable - 可修正的
affirmative - 肯定的
affirmatively - 肯定地
air-condition - 空调
aircondition - 空调装置
air-to-ground - 空对地的
air-to-air - 空对空的
air-to-surface - 空对面的
airhead - 空降场
airbus - 空中巴士
air-launch - 空中发射
abyss - 深渊
abyssal - 深渊的
aesthetically - 审美地
aesthete - 审美家
Concurrent Engineering - 并行工程
Supply Chain Management - 供应链管理
Agile Manufacturing - 敏捷制造
Pervasive Computing - 普适计算
Staff - 师资
better half - 老婆
bolt from the blue - 晴天霹雳
sixes and sevens - 乱七八糟
soft-soap - 谄媚
spill the beans - 露马脚
speak of the devil - 说曹操曹操到
quality management - 质量管理
to sign a contract - 签合同
vital signs - 生命体征
Knowledge Management - 知识管理
air-cooled - 用空气冷却的
Mad Cow Disease - 疯牛病
Interferon - 干扰素
Stem Cells - 干细胞
over-the-top - 事情做过了头, 过分
Fuel Ethanol - 燃料乙醇
the Main Force - 生力军
Nanoelectronics - 纳米电子学
Implementation date - 实施日期
Development and utilization - 开发和利用
adsorption - 吸附
Idle  - 空闲的,闲着的,懒散的,无所事事的,无效的虚度,空想,使空闲,懒散,空转,
idolization  - 偶像化,盲目的崇拜,醉心,
ignorant  - 不学无术的,无知的,愚昧的,外行的,侗,蒙,愚昧,倥,蚩,
ILL  - 有病的,不健康的,坏的,拙劣的,难以处理的,麻烦的,坏,不利地,不完全,
illegitimate  - 不法的,非嫡出的,庶生的,不合理的,不符合习惯的,非嫡出子,
illumination  - 使光耀,照明,灯饰,阐释,启发,启蒙,装饰,明亮度,亮度,
illuminative  - 照明的,启蒙的,装饰的,
illusion  - 幻觉,幻影,幻想,妄想,错误的观念,错觉,透明面纱,幻象,梦幻,
imminent  - 迫切的,紧急的,急迫的,逼近,即将来临的,即将来临,
impatience  - 无耐性,不耐,性急,暴躁,没有耐心,不耐烦,
impel  - 催促,逼迫,强迫,强使,推进,前进,
injunction  - 命令,指令,劝告,告诫,禁止命令,强制命令,
ink  - 墨水,印刷用油墨,墨汁,用墨水写,用墨水做记号,涂墨水,用墨水弄污,墨水儿,篇幅,
inly  - 在内,在心中,衷心地,
innermost  - 最里面的,最深处的,最深处,
inning  - 一局,发展的机会,好时机,执政时期,填平,开拓,
innumerable  - 数不清的,无数的,无限之多的,不计其数,不可胜数,无数,
insanity  - 疯狂,精神异状,疯狂或愚蠢的行为,精神错乱,蛊,痫,
inscription  - 题铭,碑文,铭刻,题辞,题字,题词,
insolation  - 日晒,晒干,中暑,
accelerograph - 自记加速计
accrue - 自然增加
always - 总是
ambulate - 走动
ambulant - 走动的
aisle - 走廊
A.D. - 公元
aardvark - 土豚
Aaron - 亚伦
ab. - 缩写
affection - 友爱
amicability - 友善
amicable - 友善的
amicably - 友善地
abstractive - 有抽象能力的
aerolite - 陨石
airsick - 晕机
acrobatics - 杂技
acrobatic - 杂技的
aftertreatment - 再处理
adios - 再见
alow - 在船底
aloft - 在高处
alfresco - 在户外
agoing - 在进行中
aerially - 在空中
ahorse - 在马上的
alongside - 在旁
afore - 在前
afield - 在田野
amongst - 在中间
admiring - 赞赏的
afforestation - 造林
afforest - 造林于
accomplishments - 造诣
accusing - 责难的
accretion - 增长
aggrandizement - 增大
add - 增加
aggrandize - 增加
adenoidectomy - 增殖腺切除术
abstract - 摘要
adhere - 粘附
agglutination - 粘着
agglutinate - 粘着的
agglutinant - 粘着剂
accounts - 帐目
affectionately - 挚爱地
advice - 忠告
allegiance - 忠贞
auditor - 旁听生（美）
penguin - 企鹅
modest - 谦虚的
squid - 枪乌贼,鱿鱼
bracket - 墙上突出之托架
herring - 青鱼,鲱
district - 区
heating - 取暖费
cancellation - 取消预定
anthropology - 人类学
recognize - 认清（职责等）
earnest - 认真的
conscientious - 认真的，自觉的
fluorescent lamp - 日光灯
tick - 褥子
intern - 实习生
realize - 实现（目标等）；获得（利润）
larder - 食品柜
room and board - 食宿
anteater - 食蚁兽
unify - 使成一体,统一
localize - 使地方化
enrich - 使丰富
perfect - 使完善；改善
regularize - 使系统化
modernize - 使现代化
adaptable - 适应性强的
trolley - 手推车
disciplined - 守纪律的
orderly - 守纪律的
faithful - 守信的，忠诚的
initiative - 首创精神
curriculum - 课程
timetable - 课程表
after-school activities - 课外活动
peacock - 孔雀
control - 控制
control tower - 控制台
oral test - 口试
generous - 宽宏大量的
Garbage - 垃圾费
old boy - 老生
straightforward - 老实的
divorced - 离异
auditorium - 礼堂
polytechnic institute - 理工学院/科技大学
director - 理事
profit - 利润
exercise - 练习
adroit - 灵巧的，机敏的
Record - 记录、记事
Advances - 进展
Progress - 进展
Topics - 论题、主题
Papers - 论文
Directory - 名录，指南
Content - 目次
List - 目录、一览表
Yearbook - 年鉴
Title - 篇名、刊名、题目
Review - 评论、综述
Issue - 期（次）
Handbook - 手册
Manual - 手册
Bibliography - 书目，题录
Abbreviation - 缩语和略语
Index - 索引
Summary - 提要
Bulletin - 通报，公告
Archives - 文献集
Thesaurus - 叙词表、词库
Acta - 学报
Guide - 指南
Subject - 主题
Author - 作者
Electronic Data Interchange   - 电子数据交换
For your information   - 供参考
With respect to   - 关于
Be right back   - 很快回来
By the way   - 随便说一下
I love you   - 我爱你
See you later   - 下次再会
Domain Name System   - 域名系统
Free on Board   - 装运港船上交货价
For example    - 举例
girlfriend     - 女朋友
In any event   - 无论如何
Thank you    - 谢谢
very good    - 很好
Business Reengineering    - 企业重组
Electronic Business    - 电子商务
Electronic Commerce    - 电子商务
Gigabyte     - 千兆字节
certificate of origin -  一般原产地证
document -  文件、单据
dozen -  一打
each -  每个，各
facsimile - 　 传真
free on board -  离岸价
import -  进口
civil affair - 民政
circumvention - 规避
China Securities Regulatory Commission (CSRC) - 中国证券监督管理委员会
China Mobile - 中国移动通信公司
China Foundation for Poverty Alleviation - 中国扶贫基金会
child prodigy - 神童
chief justice - 大法官
chief judge - 庭长
Chief Judge - 审判长
complete monopoly - 完全垄断
competitive sports - 竞技体育
competitive products - 精品
competitive mechanism - 竞争机制
competitive election - 差额选举
competitive bidding - 竟标
compelling obligation - 不可推卸的责任
Commissioner - 特派员
commercialization - 商品化
commercial loan - 商业贷款
commercial lending - 经常性贷款
commercial invoice - 商业发票
club together - 凑份子
closing price - 收盘价
close down - 查封
Controller - 财务主管
contract with - 承包
contract to build - 承建
contact lenses - 隐形眼镜
consumption tax - 消费税
conceptualization - 构想
concept car - 概念车
computer virus - 电脑病毒
computer crime - 电脑犯罪
compulsory education - 义务教育
comprehensive utilization of waste materials - 废物综合利用
comprehensive treatment - 综合治理
composite index - 综合指数
complimentary ticket - 优待券
complex - 情结
completion ceremony - 竣工仪式
comparative literature - 比较文学
tally company - 理货公司
common security - 共同安全
common prosperity - 共同富裕
common interests - 共同利益
commodity economy - 商品经济
current address - 目前地址
[ ]square brackets - 方括号
Management Information System - 管理信息系统
Principles of Management - 管理学原理
ambivalent - 矛盾的
adventurer - 冒险家
adventuresome - 冒险性的
airless - 没有风的
americium - 镅
America - 美国
Albuquerque - 美国城市
Americanism - 美国风
Afro-American - 美国黑人
alum - 明矾
aluminous - 明矾的
alunite - 明矾石
all-star - 明星运动员
advisability - 明智
acquiesce - 默认
acquiescent - 默许的
aim - 目标
adytum - 内殿
adductor - 内收肌
albite - 钠长石
amah - 奶妈
airworthy - 耐飞的
acidproof - 耐酸的
acid-resistant - 耐酸的
alumni - 男毕业生
agnation - 男系亲属
actor - 男演员
AFB - 空军基地
air - 空气
airy - 空气的
aerodynamic - 空气动力
aerodynamics - 空气动力学
aerodynamically - 空气动力学地
aerodynamicist - 空气动力学者
aerostatic - 空气静力学的
air-cooling - 空气冷却法
airspeed - 空速
air-raid - 空袭的
airspace - 空域
airborne - 空运
airlift - 空运
amplifier - 扩音器
abuse - 滥用
aging - 老化
acrostic - 离合诗
altruistic - 利他的
altruism - 利他主义
allied - 联盟的
affiliation - 联系
alchemy - 炼金术
continuance  - 永续,持续,继续,连续,续篇,改期续询,
contradict  - 反驳,反对,抗辩,否认,矛盾,背驰,相反,抵触,驳,
contribute  - 奉赠,捐赠,投稿,寄稿,贡献,赠送,资助,成为因素,缴纳,
convenient  - 便利的,合宜的,附近的,简便的,方便的,便,便当,便利,方便,
Converse  - 相反的事物,倒,逆向,相反的,逆向的,颠倒的,交谈,谈话,认识,
conversion  - 变换,换位,转向,改党,心理的转变,强占,换算法,兑换,转换,
converter  - 变换设备,变流器,转换器,
conveyor  - 运送器,运送者,转运带,
conviction  - 有罪判决,断罪,定罪,确信,坚信,信服,悔罪,觉悟,信仰,
cope  - 竞争,抗衡,巧妙的应付,篷盖的东西,罩袍,肩衣,覆罩,搭架子,应付,
copper  - 铜,铜币,铜器,巡官,铜的,铜色的,铜制的,用铜皮包,用铜板被覆,
Corner  - 边角,角落,转角,窘境,迫至一隅,垄断,使陷入绝境,相交成角,囤积,
cornice  - 壁带,柱带,装檐口,
corrode  - 剥蚀,使腐蚀,侵蚀,破坏,腐蚀,被侵蚀,
cot  - 乡下小屋,茅屋,槛,舍,简便卧床,摇篮,吊床,小船,放进小屋,
council  - 会议,审议会,评议会,市或镇的议会,理事会,委员,
councillor  - 议员,评议员,镇民代表,
countersign  - 暗号,口令,副印,副署,连署,确认,
courteous  - 有礼貌的,谦恭的,恳切的,会体贴的,殷勤的,有礼貌,
cousin  - 堂兄,弟,姊,妹,远亲,卿,兄弟邦的国民,表亲,堂,
cowardly  - 卑怯的,胆小的,怯懦的,懦弱地,卑怯地,怯懦地,
crackajack  - 能干的,杰出的,上等的,能干,杰出,上等,
cracking  - 分裂,分解,很快的,很好的,很美的,很快地,很好地,很美地,呖,
crash  - 砰砰碰碰的轰声,失败,摔下,粉碎,不请自来,轰隆声,破产,质地粗的布,坠毁,
craven  - 懦夫,怯懦者,胆小鬼,怯懦的,畏缩的,胆小的,
cream  - 奶油,精华,奶油色,抽取精华加乳酪,用烹调食物,成乳酪,起泡沫,乳霜,糊,
Create  - 创造,创作,产生,制造,造成,引起,
chare  - 打杂女佣,打杂,做零工,
charm  - 魅力,咒文,护符,装饰,魅惑,夺人魂魄,使欢喜,有魅力,媚,
chart  - 画图,图解,海图,航海图,图,地图,图表,表,谱,
chasm  - 深裂痕,裂口,断层,悬隔,隔膜,裂痕,
chaste  - 贞节的,纯洁的,纯正的,谦虚的,直爽的,朴素的,有道德的,有道德,贞,
chat  - 闲谈,畅谈,聊天,闲聊,啁啾的小鸟,摆龙门阵,
chatter  - 喋喋不休的谈,卡搭作响,鸣,不休的谈,使卡搭作响,闲谈,卡搭声,喋喋不休,噜,
cheaters  - (俚)眼镜,
cheeky  - 厚颜的,**的
cheery  - 活泼的,快活的,爽快的,明朗的,指心情而言,快乐的,
chemical  - 化学的,化学上的,化学用的,化学制品,化学药品,化学,
chest  - 箱,匣,金库,资金,胸,密闭容器,胸部,胸膛,匈,
chickpea  - (植)雏豆,
chiefly  - 主要,首要,第一,首先,多半地,多半,
chin  - 颚,下巴,提到下巴,聊天,颏,颔,
chink  - 裂口,裂缝,隙缝,叮当声,破裂,裂开,割裂,弄裂,塞裂缝,
chivalry  - 骑士制度,骑士道,骑士团,对妇女温柔的绅士们,妇女崇拜,骑士气概,
chock  - 楔子,木楔,楔形木垫,用楔子垫阻,收放定盘上,满满地,
christian  - 基督教徒,文明人,体面的人,基督教的,基督徒作风的,人性的,
chuck  - 抚弄,赶走,抛掷,咯咯声,颈肉,卡盘,轻拍,驱逐,丢弃,
chug  - 轧轧声,发出轧轧声,轧轧响着前进,
church  - 教会,寺院,礼拜,教派,基督教徒,一团教徒,做教会教员,使...上教堂,教堂,
cigar  - 礼,典礼,仪式,礼节,虚礼,客气,掌礼部,雪茄,雪茄烟,
Handbook - 手册
Manual - 手册
Bibliography - 书目，题录
Abbreviation - 缩语和略语
Index - 索引
Summary - 提要
Bulletin - 通报，公告
Archives - 文献集
Thesaurus - 叙词表、词库
Acta - 学报
Guide - 指南
Subject - 主题
Author - 作者
Electronic Data Interchange   - 电子数据交换
For your information   - 供参考
With respect to   - 关于
Be right back   - 很快回来
By the way   - 随便说一下
I love you   - 我爱你
See you later   - 下次再会
Domain Name System   - 域名系统
Free on Board   - 装运港船上交货价
For example    - 举例
girlfriend     - 女朋友
In any event   - 无论如何
Thank you    - 谢谢
very good    - 很好
Business Reengineering    - 企业重组
Electronic Business    - 电子商务
Electronic Commerce    - 电子商务
Gigabyte     - 千兆字节
certificate of origin -  一般原产地证
document -  文件、单据
dozen -  一打
each -  每个，各
facsimile - 　 传真
free on board -  离岸价
import -  进口
Index Medicus   - 医学索引
Edition - 版次
Section - 部分、辑、分册
 - 参见
 - 查全率
 - 查准率
Publication - 出版物
 - 等等
Supplement - 附刊、增刊
Appendix - 附录
Computer Aided Engineering   - 计算机辅助教学
Computer Aided Design   - 计算机辅助设计
abruption - 中断
abruptly - 突然地
abruptness - 突然
abscessed - 长脓疮的
ALGOL - Algol语言
A-OK - 极好
A-side - A面
put up a fight - 奋勇战斗，抵抗
blockbuster - 热门电影
action thriller - 动作片
pounce on - 抨击
information materials - 信息材料
IT Outsourcing - 信息技术外包
Virtual Reality Technology - 虚拟现实技术
abductor - 绑架者
Abe - 亚伯
abecedarian - 初学者
abed - 在床上
abele - 银白杨
aberrance - 脱离正道
aberrant - 异常的
abet - 教唆
abeyance - 搁置
abhor - 憎恶
abhorrence - 痛恨
abhorrent - 可恶的
abidance - 遵守
abiding - 容忍
abigail - 使女
ability - 能力
abiotic - 无生命的
abirritative - 镇静的
abject - 不幸的
aboard - 在船上
abode - 逗留
abolish - 废止
abolishment - 废止
A-bomb - 原子弹
abominate - 痛恨
abomination - 憎恨
aborad - 离口侧
aborative - 仔细的
aboriginal - 土著的
aboriginality - 原始状态
aborigines - 土著
abort - 异常中断
aborted - 失败的
abortifacient - 堕胎药
abortive - 无效的
aboulia - 丧失
carpenter - 木工
target - 目标,指标
motivated - 目的明确的
male - 男
schoolboy - 男生
Accountant - 会计员，会计师
airport - 机场
shuttle bus - 机场内来往班车
alert - 机灵的
brood - 鸡的统称
basic course - 基础课
pass - 及格
geometry - 几何
plan - 计划
reckon - 计算（成本等）
recorded - 记载的
Technician - 技术员
boarder - 寄宿生
crucian - 鲫鱼
double - 加倍，翻一番
reinforce - 加强
strengthen - 加强,巩固
professor - 教授
schooling - 教授,授课
dean - 教务长
teaching staff - 教育工作者(总称)
street - 街
solve - 解决
settle - 解决（问题等）
macaw - 金刚鹦鹉
dutiful - 尽职的
short-sighted - 近视
affordable housing - 经济适用房
economics - 经济学
Manager - 经理
employment - 经历
experience - 经历
conduct - 经营，处理
dynamic - 精悍的
refine - 精练，精制
smart - 精明的
mastered - 精通的
whale - 鲸
coffee table - 咖啡台
launch - 开办（新企业）
develop - 开发，发挥
opening ceremony - 开学典礼
examiner - 考试者
oven - 烤箱
available - 可到职
homework  - 在家做的工作,副业,家庭工业,作业或预习,宿题,家庭作业,
honk  - 雁鸣,汽车的喇叭声,雁鸣叫,按汽车喇叭,揿(喇叭),嘟,
honorably  - 受尊敬地,体面地,正当地,
honourable  - 可尊敬的,体面的,正当的,知耻的,荣耀的,高贵的,加在人名前的尊称,诚实的,诚实,
imply  - 暗指,含...意,意味,含蓄,包含,暗示,含有,暗含着,意味着,
imputation  - 归罪,负责,责难,
inadequate  - 不适当的,不十分的,未成熟的,不够,不适当,不足,
inasmuch  - 因此...,由于...,只要...,因此,因...之故,因┅之故,
incite  - 唆使,斗,煽,唆,挑,挑起,恿,嗾,竦,
incredible  - 不能采信的,不能信用的,难以相信的,不可思议的,难以置信的,难以置信,
incumbency  - 在职,义务,在职期间,
indefinite  - 不确定的,模糊的,不明了的,不一定的,无限的,无期限的,不明确的,不定,不明确,
independence  - 独立,自主,自立,独立心,可维持独立生活之收入,独立性,
independent  - 独立的,自主的,大胆的,自食其力的,独立者,无党派人士,独立教会主义者,独,独立,
index  - 索引,引得,指示物,食指,指数,禁书目录,指标,编索引,索引指数,
indifference  - 不关心,不在乎,冷淡,不重要的事,细微的事,不重视,
indiscriminate  - 无差别的,不分皂白的,杂陈的,
infatuation  - 迷惑,迷恋,醉心,
infer  - 推理,推论,推断,表示,意味,含有...意味,
inference  - 推理,推断,推论的结果,结论,推论,论断,
infest  - 群袭,爬满,在...出没,蹂躏,横行,扰乱,
infinite  - 无限的,庞大的,无数的,不定的,无限大的,无限,无限物,无限空间,项,
infinitesimal  - 极小的,极微的,无限小的,极小量,极微量,无限小,
influence  - 影响,作用,感化力,权势,有影响力的人,感应,发生影响,改变,势,
inform  - 通知,报告,鼓吹,充满,告发,密告,报信,达,诜,
ingenuity  - 发明才能,贤明,聪明,巧妙,精妙,创造力,
ingress  - 进入,入口,准许进入,
fraud  - 欺骗,欺诈,欺诈行为,**,假东西,弊,骗局,舞弊,作弊,
gnarly  - 多节的,粗糙的,执拗的,
goody  - 身分低微之老妇,媪,糖果,感伤的,伪善的,太好了,
goof  - 呆子,傻瓜,弄糟,混,打发时间,出大错,
gout  - 味,趣味,嗜好,痛风,一滴,一团,
grab  - 突攫,抓握,抢去,略夺的行为,攫取机,起重钩,小孩的纸牌游戏之一种,抓,抓住,
grandeur  - 壮伟,庄严,壮观,伟观,伟大,崇高,威严,威风,高贵,
grasshopper  - 蚱蜢,蝗虫,蟋蟀之类,小型侦察机,蚂,蚱,蛩,蜢,蠓,
grassy  - 草深的,像草的,绿色的,如草的,如草,萃,
grate  - 炉架,炉,铁栅栏,选矿筛子,装铁栅栏于,擦碎,互磨擦,轧,使刺激神精,
gravel  - 碎石,砂砾层,肾砂,铺碎石,使搁浅在碎石滩上,使困惑,因碎石而受伤,砾,砂,
gravy  - 闪耀,刺眼,怒目而视,瞪眼,镜般光滑的表面,光滑而发亮的,肉汁,调味肉汁,卤,
greenery  - 绿叶,绿树,装饰用的绿树枝或叶,
greet  - 致候,致敬,迎接,看得到,听得到,闯进,哭,叹,悲伤,
grieve  - 使悲伤,使苦恼,使伤心,悲伤,悲叹,伤心,
grip  - 紧握,特殊握手方法,把手,支配,领悟力,旅行包,剧痛,扣住,握住,
grizzle  - 灰色,灰色物,斑白的发,变成灰色,发脾气,使成灰色,
grocery  - 食品杂货,食品杂货店,杂货,
groom  - 马夫,新郎,属英国宫内的侍从官,下男,修整,照顾,教育,训练,使准备,
growl  - 吠声,不平,咆哮声,怒吠,咆哮,吼,鸣不平,隆隆作响,咆哮著说,
guest  - 客人,来宾,旅馆等投宿的客人,寄生动物,宾,客,
guidance  - 向导,指导,学生指导,辅导,指挥,指示,
guiltless  - 无辜的,没罪的,不知...,对...无经验的,不拥有,具有...的,
private school - 私塾
private capital - 民间资本
prioritize - 重点发展
plant community - 植物群落
planned economy - 计划经济
place of origin - 原产地
quadruple - 翻两番
Qinghai-Tibet Plateau - 青藏高原
put on airs - 摆架子
put - 看跌/看涨期权
purpose-made - 特制的
purified water - 纯净水
purchasing power parity - 购买力平价法
purchasing power - 购买力
puppy love - 早恋
punk - 朋克
punish severely - 严惩
publicity stunt - 做秀
protein engineering - 蛋白质工程
proprietary intellectual property rights - 自主知识产权
propose a toast - 举杯
propose a toast - 敬酒
recycled paper - 再生环保纸
recycled paper - 再生纸
recoverable reserves - 可采储量
Minus  - 负号,不足,减的,负的,阴性的 减,缺,
minutely  - 细,仔,详细地,精密地,每分钟地,每分钟的,
miscellaneous  - 杂项的,杂,杂项,
mischief  - 危害,坏影响,恶意,恶作剧,导至危害的行为,淘气,顽皮,恶作剧者,小淘气,
miser  - 吝啬鬼,守财奴,贪婪之人,可怜的人,吝啬,财迷,
mitigation  - 缓和,减轻,镇静,
mitt  - 露指而长可盖住前腕的手套,捕手,一垒手用手套,手,拳击用手套,手套,
mnemonic  - 记忆的,助记的,助记符,
manufacturer  - 制造者,制作者,生产者,工厂主人,制造业者,生产企业,
manuscript  - 用手写的,手抄的,抄本的,抄本,原稿,手抄本,手稿,草,稿,
marble  - 大理石,弹子游戏,冷酷的,坚硬的,洁白的,使具有大理石花纹,
marginal  - 边缘的,栏外的,末端的,境界的,勉强可收支平衡的,边际的,界限的,边缘,界限,
mart  - 商业中心区,市场,拍卖室,买卖,拍卖场,商业中心,
masculine  - 男性的,男的,雄的,像男的,雄纠纠的,男子气的,男性,男性语词,男子气,
mash  - 麦芽汁,米糠泡的家畜饲料,研碎,马铃薯泥,被爱慕的人,捣烂,使著迷,捣碎,糊,
masterstroke  - 巧妙的动作,神技,主线,
materially  - 实质地,物质地,显著地,甚大,物质上的,物质上,
Matrix  - 矩阵,母体,子宫,细胞,脉石,模型,
matron  - 妇女,主妇,保姆,女舍监,护士长,婆,
mattress  - 底垫,空气床,沉床,垫子,床垫,褥,
maze  - 迷阵,迷宫,困惑,纠纷,混乱,迷惑,使困惑,使茫然,迷失,
meandering  - 曲径,漫步,瞎谈,曲折的,漫步的,聊天的,
mechanic  - 机械工,机械修理工,职工,工匠,机械技师,技工,
mechanism  - 机械结构,策略,机械论,宇宙机械,技巧,心理过程,机构,结构,机关,
medially  - 中间地,平均地,中庸地,
afterimage - 余象
aftershock - 余震
amusement - 娱乐
agreeable - 愉快的
ammoniated - 与氨化合了的
ana - 语录
allegory - 寓言
allegorically - 寓言地
accuser - 原告
aetiology - 原因之说明
allow - 允许
allowable - 允许的
admission - 允许进入
accumulator - 蓄电池
absolve - 宣布免除
adjudgement - 宣告
Adventist - 耶稣复临论者
ambition - 野心
amateur - 业余爱好者
acerate - 一端尖的
all-in - 一切的
all-in-one - 一体化
accord - 一致
accordance - 一致
accordant - 一致的
aedes - 伊蚊
adjudgment - 依法判处
adherence - 依附
allegedly - 依其申述
according - 依照
alphabetize - 依字母顺序
alphabetical - 依字母顺序的
amenity - 宜人
ambulation - 移动
acetaldehyde - 乙醛
acetylene - 乙炔
acetal - 乙缩醛
acetamide - 乙酰胺
acetylcholine - 乙酰胆碱
acetyl - 乙酰基
acquired - 已获得的
accepted - 已接受的
afteryears - 以后的岁月
allogamy - 异花受粉
acre - 英亩
alimentation - 营养
affect - 影响
advocation - 拥护
aeonian - 永久的
aeon - 永世
interpose  - 放入,插入,提议,介入,干涉,插嘴,
interrelate  - (使)相互关连,
intervene  - 插入,插进,介于其间,中间发生干扰,干涉,介入,调停,参加诉讼,干预,
introduce  - 引导,投入,给与初次经验,传授,介绍,使进入社交界,提议,倡,介,
intrude  - 塞入,挤入,迸入,强使,迫使,闯入,侵入,多管闲事,干扰,
invade  - 侵扰,侵略,闯入,蜂拥而上,袭击,袭来,侵犯,入侵,宰割,
invitation  - 招待,邀请,请帖,邀请书,劝诱,魅力,
invite  - 邀请,劝诱,恳请,惹起,招致,发生,魅惑,诱惑,请帖,
invited  - 邀请,引起,招致,
iron  - 铁,制铁工具,熨斗,手枪,强壮,坚强的,坚忍不拔的,残酷的,上手拷,
irradiation  - 发光,放射,照射,
irresolute  - 踌躇,徊,徘,旁,俳,彷,徨,憧,蹰,
ISDN  - 整体服务数位网路,整体数位服务网路,综合服务数位网络,
island  - 岛,岛状物,安全岛,月台,司令塔,使孤立,使散布如岛屿,岛屿,洲,
ivory  - 象牙,象牙质,象牙色,牙齿,象牙镶嵌,骰子,钢琴的键盘,象牙的,牙,
Ja -  ,一月
jack  - 男人,年轻人,杂工,水手,起重机,烤肉架,捕鱼灯,顶起,小起重机,
Japanese  - 日本,倭,日本的,日本人的,日本人,日语,
hector  - 栌辱,威吓,作威作福,
helmet  - 盔,钢盔,消防盔,盔帽,盔甲,胄,
hence  - 由是,因此,今后,从此,今世起,!出去!,
hereditary  - 世袭的,世代相传的,继承关系的,由于遗传的,遗传的,遗传,
hermit  - 行者,隐士,隐居者,胡桃,萝卜乾等制成的糖果,蜂雀,
heroism  - 英雄的气质,勇壮,豪勇,忠烈,英雄的行为,英勇的行为,
hesitate  - 迟疑,踌躇,犹豫不定,支吾其辞,吞吞吐吐,犹豫,踌,躇,趄,
heterogeneous  - 驳杂,多相,异质,异种的,异质的,由不同成分形成的,
hey  - 表示惊,喜,疑虑,促使注意的喊声,!喂!计程车!,喂,哎,哎哟,嘿,
highlight  - 突出,加亮区,精彩场面,加亮,使显著,以强光照射,
highway  - 大道,公路,主要交通线,高速公路,冲,坦白途,
hindrance  - 妨碍,障碍,阻力,
hip  - 臀部,屁股,腰骨,基节,隅栋,玫瑰,忧郁,忧愁,喝采欢呼声,
hiss  - 发出嘶嘶声,发虚声制止,虚声,嘶嘶声,叱责声,蛇等发出的声音,嘘声,嘶,嘘,
hitherto  - 迄今,到此,至今,
hoar  - 白的,灰色的,发白的,灰白,灰白色,白霜,
hod  - 木制容器,煤斗,装木炭容器,
holdout  - 抵抗,坚持,支持,
homeland  - 本国,故乡,祖国,
homework  - 在家做的工作,副业,家庭工业,作业或预习,宿题,家庭作业,
honk  - 雁鸣,汽车的喇叭声,雁鸣叫,按汽车喇叭,揿(喇叭),嘟,
honorably  - 受尊敬地,体面地,正当地,
honourable  - 可尊敬的,体面的,正当的,知耻的,荣耀的,高贵的,加在人名前的尊称,诚实的,诚实,
imply  - 暗指,含...意,意味,含蓄,包含,暗示,含有,暗含着,意味着,
imputation  - 归罪,负责,责难,
inadequate  - 不适当的,不十分的,未成熟的,不够,不适当,不足,
inasmuch  - 因此...,由于...,只要...,因此,因...之故,因┅之故,
incite  - 唆使,斗,煽,唆,挑,挑起,恿,嗾,竦,
incredible  - 不能采信的,不能信用的,难以相信的,不可思议的,难以置信的,难以置信,
incumbency  - 在职,义务,在职期间,
indefinite  - 不确定的,模糊的,不明了的,不一定的,无限的,无期限的,不明确的,不定,不明确,
independence  - 独立,自主,自立,独立心,可维持独立生活之收入,独立性,
hospital  - 医院,动物医院,慈善医院,养育院,救济院,公共学校,
housing  - 供给住宅,避难所,住房,
hum  - 不哼气,以鼻音哼歌,好景气,嘴中细语,哼声,远方嘈杂声,喧哗,诈欺,哼,
humanitarian  - 人道主义者,博爱者,基督凡人论者,人道主义的,博爱的,相信基督为凡人的,
humour  - 幽默,诙谐,情绪,体液,使满足,迁就,
hundred  - 多数的,百数,百数的东西,一百的记号,百米赛跑,百元,百岁,百,一百,
hurricane  - 暴风,台风,激发,飓风,暴风骤雨,飓,
I  - 鄙人,我,吾,余,予,朕,冰冻,使成冰,用冰覆盖,
ice&nbspcream       - 冰淇淋
fifth  - 第五的,五分之一的,第五,五分之一,第五日,第五度,
fifty  - 五十,五十岁的,五十个的,许多的,五十个,五十岁,
filament  - 细丝,细线,单纤维,花丝,白热丝,丝状物,
finely  - 再见!再会!一路平安!,告别的,临别的,告别,离别,告别辞,
firmness  - 坚固,坚牢,坚定,不动,刚毅,坚固性,
first-line  - 第一线的,头等的,最重要的,
flagging  - 铺砌石板,铺石材料,石板路,下垂的,衰弱的,委顿的,
flank  - 侧部,腰窝肉,侧面,侧翼,侧堡,站在...的侧面,面临著...,侧边,腹部,
flare  - 闪光,怒气冲冠,燃烧,张开部份,摇泄,发出闪光,用闪光作信号,夸示,闪亮,
flare-up  - 火焰,光等的骤发,骤燃,
flat-footed  - 扁平足的,断然的,直截了当的,
flatly  - 断然,毅然,直截了当,
flexure  - 屈曲,弯曲部分,折缝,
flick  - 快速的轻打,轻打声,弹开,轻弹,轻轻拂去,忽然摇动,
flight  - 飞行,航程,追赶猎物,迁徙,奔放,射远竞赛,飞行小队,射击,航行,
flirt  - 调情取乐,忽然移动,玩弄,忽然弹出,用力摇动,轻浮的女人,急投,调戏,调情,
flounce  - 衣裙上的荷边装饰,挣扎,挣脱,饰以荷叶边,跳动,突然离去,
flounder  - 挣扎,折腾,挣扎著前进,著慌,一再失败,焦躁,辗转,比目鱼之类,比目鱼,
flour  - 面粉,小麦粉,粉,粉末,白面,面,
fluke  - 侥幸成功,锚爪,比目鱼,侥幸,倒霉,蛭,
flutter  - 用振翅击,飘动,仓惶失措,挥动,使慌张,跳动,打赌,摇晃,摆动,
fluxion  - 流动,不断的变化,转变,
french  - 法国的,法语的,法国人的,法国式的,法国语,法国人,
frenzy  - 使狂乱,使激怒,狂乱,狂怒,狂暴,热狂,
fresco  - 壁画,在新涂灰泥的墙壁上作的水彩画,作壁画于,
friday  - 星期五,...的忠仆,忠实的男佣,
fright  - 惊骇,可怕的东西,奇丑的人,非常奇怪的东西,使惊吓,使胆怯,
frighten  - 使骇怕,使吃惊,恐吓做...,突然骇怕,震惊,恫,
frisk  - 乱跳,欢闹,活跃,欢跃,蹦跳,轻摇,
frontier  - 国境,开拓与未开地之交界地方,边境,未知的领域,限界,边疆,边陲,裔,陲,
fruitless  - 不结果的,不长果实的,无子的,无效果的,无益的,不结果,
Full  - 全部,充满的,完全的,丰富的,完美的,丰满的,详尽的,完全地,整整,
funeral  - 葬礼,出殡行列,告别式,该做的事,讨厌的工作,埋葬的,葬礼用的,丧礼时的,丧,
furnace  - 熔矿炉,炉,火炉,暖气闭锁炉,灼热的地方,严格的锻链,
fury  - 激怒,热狂,猛烈,复仇三女神之一人,冤魂,泼妇,悍妇,忿怒,暴怒,
gab  - 饶舌,爱说话,多嘴,空谈,瞎扯,唠叨,
gaiety  - 愉快,快活,高兴,欢乐,狂欢,华美,
gale  - 强风,疾风,暴风,微风,薰风,狂喜,欢乐,爆发,杨梅科灌木,
gall  - 胆汁,苦味,憎恶,水彩用透明液体,五倍子,擦伤,使焦急,使怒,浸五倍子液,
gallery  - 看台,特别席,通俗趣味,回廊,画廊,摄影场,船尾展望台,坑道,长廊,
gammon  - 腌猪后腿,胡说,腌,欺骗,作假,胡说八道!,
abomination - 憎恨
aborad - 离口侧
aborative - 仔细的
aboriginal - 土著的
aboriginality - 原始状态
aborigines - 土著
abort - 异常中断
aborted - 失败的
abortifacient - 堕胎药
abortive - 无效的
aboulia - 丧失
abounding - 丰富的
about - 关于
aboveboard - 光明正大的
adjutant - 助手
aide - 助手
affusion - 注水
advertent - 注意的
ahold - 抓
allergist - 专科医师
absolutism - 专制主义
absolutist - 专制主义者
aba - 毛织物
abac - 算图
abaci - 算盘
aback - 向后地
abacus - 算盘
Abaddon - 地狱
abaft - 向船尾
abandon - 放弃
abandonment - 放弃
abas - 打倒
abase - 降低
abasement - 降低
abash - 使局促不安
abashed - 不安的
abatement - 消除
abattoir - 屠宰场
abaxial - 离轴的
abb - 横丝
Abba - 神父
abbe - 神父
abbess - 女修道院院长
abbey - 修道院
abbot - 修道院
abbr. - 缩写
abbreviate - 缩写
abbreviated - 简短的
abbreviation - 缩写
ABC - 美国广播公司
rival - 竞争者
allow - 承认
auditor - 审核员
deliberate - 深思熟虑
duly - 适时地
repurchase - 购回
usurp - 篡夺
marketers - 营销人员
vesting - 授予
outs - 收购
collect - 收款
overwhelming - 势不可挡的
employ - 雇用
rumor - 传闻
redound - 回报
apt - 恰当的
informative - 情报的
congratulations - 贺词
balks - 障碍
subscribe - 认购
empowering - 分权
divestiture - 资产剥离
buyouts - 收购
salary - 薪资
dell - 戴尔
privately-run - 民营
eps - 每股收益
benchmarking - 标杆
leadership - 领导力
prise - 企业
inspiriting - 激励
refinancing - 再融资
payable - 应付
deferred - 递延
private-owned - 私营
counterintelligence - 反竞争情报
leverage - 杠杆率
governs - 治理
citroen - 雪铁龙
administers - 治理
reward - 奖金
motorola - 摩托罗拉公司
buyout - 杠杆收购
discounting - 贴现
opportunist - 机会主义
entrepreneurship - 企业家能力
tacit - 意会
chandler - 钱德勒
impairments - 减值
forethought - 先见
Ministry of Civil Affairs - 民政部
Ministry of Agriculture - 农业部
minister without portfolio - 不管部部长
mining right - 开采权
minibus - 小巴
mineral resources - 矿源
millennium bug - 千年问题、千年虫
military court - 军事法院
military confrontation - 军事对峙
militarily competent - 军事过硬
metaphysics - 形而上学
merger - 联合；合并
Mencius - 孟子
meet-and-greet - 见面会
medical insurance - 医疗保险
media - 传媒
mechanical and electrical products - 机电产品
Mechanic - 机械师
nuclear family - 核心家庭
non-aligned movement - 不结盟运动
noise abatement - 噪声治理
nirvana - 涅磐(佛)
nine-year compulsory education - 九年义务教育
night life - 夜生活
niche - 利基
NHK - 日本广播协会
new issues - 新发行股票
neutron bomb - 中子弹
networking - 网络化
net friend - 网友
net ball - 擦网球
natural rights - 天赋人权
nationwide census - 全国人口普查
National Tourism Administration - 国家旅游局
national economic census - 全国经济普查
National Committee of the Chinese People's Political Consultative Conference (CPPCC) - 中国人民政治协商会议全国委员会（简称全国政协）
national cohesion - 民族凝聚力
nation state - 民族国家
nanometer - 纳米
mycoplasma - 支原体
mutual funds - 共同基金
Ministry of Water Resources - 水利部
Ministry of Science and Technology - 科学技术部
open an account - 开户头
offside - 越位
offshore area - 近海地区
off-line - 脱机
Office of Overseas Chinese Affairs - 侨务办公厅
office building - 写字楼
Secretariat of the Central Committee of the CPC - 中央书记处
sado - 茶道
rural credit cooperatives - 农村信用社
royalty rate - 版税率
round-trip ticket - 往返票
rollercoaster - 过山车
roller coaster - 过山车
rob Peter to pay Paul - 拆东墙补西墙
returned students - 归国留学生
returned overseas Chinese - 归侨
rechargeable batteries - 充电电池
rate of contraception - 节育率
rare or endangered species - 珍稀濒危物种
Ramadan - 斋月(伊斯兰教)
policy banks - 政策银行
point of sale - 销售点
plenary meeting - 全体会议
tropical rain forest - 热带雨林
raffle - 对奖活动
radioactive contamination - 放射性污染
radio and television university - 广播电视大学
quota - 配额
quality of education - 教育质量
Quality Inspector - 质检员
regional protectionism - 地方保护主义
regional disparity - 地区差异
regional autonomy - 区域自治
re-entry module - 返回舱
re-employment service center - 再就业服务中心
Red Ribbon - 红丝带
real estate market - 房地产市场
reach a consensus - 达成共识
road toll - 养路费
road show - 路演
road of socialism with Chinese characteristics - 有中国特色的社会主义道路
rip off - 宰人
pail - 木桶
break the deadlock - 打破僵局
brain drain - 智囊流失
brain drain - 人才流失
box office - 票房
bowling - 保龄球
bottom line - 底线
bottleneck - 瓶颈
block - 起跑器
blind date - 相亲
black whistle - 黑哨
bite off more than one can chew - 贪多嚼不烂
birth rate - 人口出生率
bird flu - 禽流感
bioterrorism - 生物恐怖主义
amassment - 积蓄
activate - 激活
activating - 激活
actuator - 激励者
activize - 激起
ad-lib - 即兴表演
admirably - 极好地
allegro - 急速地
acute-care - 急性病治疗的
aggregation - 集合
aggregative - 集团的
album - 集邮本
almost - 几乎
account - 计算
adding - 加
addition - 加
adder - 加法器
affiliate - 加入
accelerate - 加速
aerobics - 健美操
AC - 交流
AC/DC - 交直流
agitate - 搅动
accept - 接受
acceptance - 接受
acceptor - 接受者
abstinence - 节制
aftermath - 结果
agglomeration - 结块
ally - 结盟
algal - 海藻的
agued - 害疟疾的
afraid - 害怕
ambiguity - 含糊
alcoholic - 含酒精的
algidity - 寒气
airways - 航空公司
across - 横过
abscissa - 横坐标
aftereffect - 后效
ampullae - 壶腹
aleurone - 糊粉
amber - 琥珀
amidate - 化为醯胺
ambidexterity - 怀二心
ambidextrous - 怀有二心的
acclamation - 欢呼
alleviation - 缓和
amble - 缓行
absurdity - 荒谬
Security Council - 安理会
Securities and Exchange Commission - 证券交易委员会
search engine - 搜索引擎(计算机)
scooter - 滑板车
scoop - 独家新闻
scale merit - 规模效益
sauna - 桑拿浴
satellite town - 卫星城
satellite communication - 卫星通讯
SARS case - 非典病例
sample survey - 抽样调查
salvage ship - 海上救助船
Sales Manager - 销售部经理
share capital - 股本
Shangri-la - 香格里拉
sexually transmitted disease - 性病
sex education - 性教育
sense of ownership - 主人翁精神
senior lecturer - 高级讲师
senior engineer - 高级实验师
senior economist - 高级经济师
senior agronomist - 高级农艺师
Senior Accountant - 高级会计师
semifinals - 半决赛
sell-off - 处理存货
sell well - 走俏
seize the opportunity - 抓住机遇
Section Chief - 工段长
Secretariat - 秘书处
Secretarial Pool - 秘书室
secret ballot - 不记名投票
secondary pollution - 二次污染
secondary market - 二级市场
Snow White - 白雪公主
snakehead - 蛇头
smooth transition - 平稳过渡
slush fund - 用于收买官员的资金
simultaneous interpretation - 同声传译
Siamese twins - 联体婴儿
short supply - 供不应求
short of cash - 现金不足
shopping online - 网上购物
shopping mall - 商品步行街
shock brigade - 突击队
service trade - 窗口行业
service call - 业务电话
sperm bank - 精子库
speed limit - 限速
speech recognition - 语音识别
specialty - 拿手项目
financial - 融资
multinational - 跨国公司
merger - 并购
advantage - 优势的
enterprise - 为企业
clusters - 集群
supplier - 供应商
acquisition - 购
stock - 股权
transnational - 跨国
control - 控制权
salary - 薪酬
team - 团队
earnings - 盈余
managers - 经营者
outsourcing - 外包
owner - 所有者
acquisitions - 购
merger - 兼并
manager - 经理人
operator - 经营者
haier - 海尔
appraisal - 考核
personnel - 员工
lean - 精益
goodwill - 商誉
financial - 理财
achievement - 绩效
erp - 企业资源计划
partnership - 伙伴关系
tax - 纳税
equity - 权益
managerial - 经营
owners - 所有者
enterpriser - 企业家
stakeholders - 利益相关者
reengineering - 重组
enterprise - 企业
Development - 试验发展
Audience segmentation - 受众分割
Digital Earth - 数字地球
Grid Computing - 网格计算
Network Database - 网络数据库
Crisis Management - 危机管理
liquid crystal - 液晶
veto power - 一票否决权
Telemedicine - 远程医学
Manned Space Flight - 载人航天
manned spaceflight - 载人航天
The Knowledge Economy - 知识经济
adult education - 成人教育
honest - 诚实的
export - 出口
Cashier - 出纳员
Physical Education - 体育
Chief Engineer - 总工程师
Sales Engineer - 销售工程师
software engineering - 软件工程
College English - 大学英语
business experience - 工作经历
research fellow - 研究员
International Finance - 国际金融
Computer Graphics - 图形学原理
professional history - 职业经历
participate in - 参加
second job - 第二职业
Contract Law - 合同法
job objective - 工作目标
sort out - 清理
business phone - 办公电话
home phone - 住宅电话
office phone - 办公电话
College Physics - 大学物理
native place - 籍贯
social practice - 社会实践
Word Processing - 数据处理
associate professor - 副教授
guest professor - 客座教授
autonomous region - 自治区
Public Relation - 公共关系学
Operational Research - 运筹学
research society - 研究会
family status - 家庭状况
marital status - 婚姻状况
foreign student - 外国学生
graduate student - 研究生
educational system - 学制
exploit  - 开发（资源，产品）
eliminate  - 消除
boar - 雄猪,种猪
calf - 小牛,牛犊
crayfish - 小龙虾,喇蛄
make - 制造
koala - 考拉,树袋熊
professional - 职业经历
mullet - 乌鱼,黑鱼
lengthen - 延长
guide - 指导；操纵
replace - 接替，替换
master - 小学校长（美）
activity - 活跃
actively - 活跃地
alive - 活着的
accelerometer - 加速计
amalgam - 汞合金
accrete - 共生
age-old - 古老的
amphitheater - 古罗马剧场
aforethought - 故意的
advisor - 顾问
accounting scandal - 财务丑闻
accounting fraud - 假帐
accounting computerization - 会计电算化
accountant - 会计员
accountability system - 责任追究制度
Academician - 院士
abuse of power - 滥用权力
a well-off society in an all-round way - 全面小康社会
a unified multi-ethnic country - 统一的多民族国家
A share market - A股市场
An important factor (contributing to/resulting in) substantial price hikes lies in the - 导致价格持续增长的一个重要因素在于物价的逐步放开及价格结构调整。
an aging population - 人口老龄化
all risk insurance - 统保
airborne division - 空降师
air pollution - 空气污染
air pollutants - 空气污染物
air crash - 空难
AIDS (Acquired Immune Deficiency Syndrome) - 艾滋病(获得性免疫缺陷综合征)
agronomist - 农艺师
agricultural tax - 农业税
agricultural reclamation - 农垦
agricultural machinery - 农机
aging effect - 老化效应
Adviser - 顾问
advertising agent - 广告代理行
admissions office - 招生办公室
administrative proceedings - 行政诉讼
administrative licensing - 行政许可
addict - 痴迷者
asexual reproduction - 无性生殖法
ASEAN Free Trade Area - 东盟自由贸易区
liberal arts - 文科
Artist - 美术师
applied science - 应用科学
application letter - 求职信
anti-virus software - 防病毒软件
anti-secession law - 反分裂国家法
anti-dumping measures - 反倾销措施
anthrax - 炭疽
answering machine - 电话留言机
associate professor - 副研究员
associate degree - 大专文凭
assistant president - 总裁助理
assistant editor - 助理编辑
arrest warrant - 逮捕证
arms race - 军备竞赛
arms limitation - 限制军备
arms embargo - 武器禁运
armed conflict - 武力冲突
arbitrage - 套利
beer belly - 啤酒肚
bear market - 空头市场
barter - 易货
bartender - 调酒师
barriers - 篱笆墙
barmaid - 陪酒女郎
bar counter - 吧台
baptism - 洗礼
backpacker - 背包旅行者
award presentation ceremony - 颁奖大会
autonomous prefecture - 自治州
auto financing company - 汽车金融公司
auction - 拍卖
attract investment - 招商
attract foreign investment - 对外招商
Blu-ray Disc - 蓝光光盘
bluetooth - 蓝牙技术
blue chip - 绩优股
blockbuster - 大轰动
Bill of Rights - 权力法案
bikini - 比基尼
bidding documents - 标书
bidding document - 标书
bid for the Olympic Games - 申办奥运会
Berne Convention - 《伯尔尼公约》
Berne Convention - 《伯尔尼公约》（有关保护文学和艺术作品版权的公约）
behind bars - 坐牢
business travel - 商务旅游
Business scope - 业务范围
Business Manager - 营业部经理
Business ethics - 商业道德
Business card - 名片
bubble bath - 泡沫浴
brown bag - 便当
break the deadlock - 打破僵局
brain drain - 智囊流失
brain drain - 人才流失
box office - 票房
bowling - 保龄球
bottom line - 底线
accidental - 意外的
acceptation - 意义
ala - 翼
alary - 翼状的
accordingly - 因此
afterworld - 阴间
allophonic - 音位变体的
ackey - 银元
allergenic - 引起过敏症的
adhibit - 引入
adduction - 引用
adduce - 引证
Amazonian - 印第安人
amenable - 应服从的
accountable - 应负责的
acoustic - 有关声音的
activated - 有活性的
air-wise - 有经验的
advantageously - 有利地
amiss - 有毛病的
amusing - 有趣的
amusingly - 有趣地
alate - 有翼的
alated - 有翼的
alible - 有营养的
accountability - 有责任
acquainted - 有知识的
again - 又
allurement - 诱惑
afterimage - 余象
aftershock - 余震
amusement - 娱乐
agreeable - 愉快的
ammoniated - 与氨化合了的
ana - 语录
allegory - 寓言
allegorically - 寓言地
accuser - 原告
aetiology - 原因之说明
allow - 允许
allowable - 允许的
admission - 允许进入
accumulator - 蓄电池
absolve - 宣布免除
adjudgement - 宣告
Adventist - 耶稣复临论者
ambition - 野心
amateur - 业余爱好者
acerate - 一端尖的
all-in - 一切的
acre - 英亩
alimentation - 营养
affect - 影响
advocation - 拥护
aeonian - 永久的
aeon - 永世
alway - 永远
Aeneas - 勇士
advantage - 优势
air-sea - 由空至海
airbrush - 油漆喷雾器
aerotropism - 向气性
alee - 向下风
acorn - 橡子
ait - 小岛
acinus - 小核果
aglet - 小金属箍
alveolus - 小孔
alley - 小路
alleyway - 小巷
alular - 小翼羽的
aidance - 协助
absent-minded - 心不在焉的
absent-mindedly - 心不在焉地
accredit - 信任
adherent - 信徒
academician - 学会会员
academia - 学术界
academically - 学术上
academy - 学院
academic - 学院的
alabaster - 雪花石膏
Adam - 亚当
Adamic - 亚当的
Adams - 亚当斯
Adriatic - 亚得里亚海的
Aden - 亚丁
Aire - 亚耳河
Achaea - 亚该亚
Ahab - 亚哈-以色列之王
Alexander - 亚历山大
Alexandria - 亚历山大大帝
Amazon - 亚马逊河
AMorite - 亚摩利人
adjourn - 延期
AMish - 严紧派
acrimonious - 严厉的
alongshore - 沿着岸
academe - 研究院
amniotic - 羊膜的
acquaintance  - 相识,相熟,熟人,知识,心得,熟知,
acquire  - 取得,获得,学得,养成,带来,使蒙受,
acquisition  - 取得,获得,学得,取得物,所获,收获,
acrobatics  - 把戏,特技,杂技,
act  - 行动,扮演,表演,动,动作,举动,
acting  - 演戏,行为,假装,代理的,临时的,演出用的,
adhesive  - 粘着的,有粘性的,粘剂,
adjuvant  - 辅助的,佐药,助手,
admission  - 准予入场,入学,入会,入场,入会费,承认,招认,自白,许可,
ADP  - 自动数据处理
ADSL  - 非对称式数据用户线
advising  - 劝告,通知,忠告,
affectation  - 假装,虚饰,做作,
affection  - 爱情,情爱,情义,感情,疾病,影响,性情,性质,爱,
affirmation  - 肯定,断言,主张,
affray  - 吵架,骚扰,滋事,
afield  - 至野外,在田野,至远方,
afterthought  - 事后才有的想法,追悔,再思,
agglutinant  - 粘着剂,胶合剂,粘性的,
agglutination  - 粘着,胶合,粘着状态,
agitate  - 搅动,骚动,使兴奋,热烈讨论,把...当问题,煽动,鼓动,荡,汤,
agitation  - 搅动,动摇,搅拌,搅乱,兴奋,议论,煽动,运动,鼓动,
whore  - **,娼妓,**
slicker  - 防水衣,雨衣,**
pervading  - 溥,  
pre-  - ...之前
A.d.  - 西元
international -  国际的
invoice -  发票
medium -  中等，中级的
maximum - 　 最大的、最大限度的
metric ton -  公吨
net weight -  净重
packing list -  装箱单、明细表
percent -  百分比
price -  价格
purchase -  购买、购货
reference -  参考、查价
sales contract -  销售确认书
telex -  电传
Annals - 纪事
 - 禁用词
Volume - 卷
Annual - 年鉴，年度
Abstracts - 文摘
Institute - 学会、研究所
Dissertations - 学位论文
Journal - 杂志、刊
Symposium - 专题学术讨论会
Encyclopedia - 百科全书
friendly match - 友谊赛
fresh goods - 鲜活商品
freedom of the press - 新闻自由
free kick - 任意球
free competition - 自由竞争
four-letter word - 粗口
forward contract - 期货合同
forward contract - 远期合同
formalism - 形式主义
forest coverage rate - 绿地覆盖率
Foreman - 作业班长
good start - 开门红
golden monkey - 金丝猴
golden goal - 金球制
gold standard - 金本位
GNP (Gross National Product) - 国民生产总值
genome - 基因组
Genghis Khan - 成吉思汗
genetically modified - 转基因的
genetic mutation - 基因突变
genetic engineering - 遗传工程
generation gap - 代沟
General Office of the State Council - 国务院办公厅
house purchasing - 置业
host the 2008 Olympic games - 主办2008年奥运会
horror film - 恐怖片
Hope Project - 希望工程
Honorary Chairman - 名誉董事长
ground crew - 地勤人员
gross national product (GNP) - 国民生产总值
gross domestic product (GDP) - 国内生产总值
grocery store - 小卖部
greenhouse gases - 温室气体
green card - 绿卡
green bank - 绿色银行
graduation design - 毕业设计
Governor - 省长
government procurement - 政府采购
group technology - 成组技术
group psychology - 从众心理
infant industries - 幼稚产业
income tax - 所得税
income gap - 收入差距
income from property - 产权收益
inbound tourism - 入境旅游
inbound tourism - 国内游
in turn - 轮流（坐庄）
in place - 到位
hydrogen bomb - 氢弹
human genome - 人类基因图谱
Chief Engineer - 总工程师
Sales Engineer - 销售工程师
software engineering - 软件工程
College English - 大学英语
business experience - 工作经历
research fellow - 研究员
International Finance - 国际金融
Computer Graphics - 图形学原理
professional history - 职业经历
participate in - 参加
second job - 第二职业
Contract Law - 合同法
job objective - 工作目标
sort out - 清理
business phone - 办公电话
home phone - 住宅电话
office phone - 办公电话
College Physics - 大学物理
native place - 籍贯
social practice - 社会实践
Word Processing - 数据处理
associate professor - 副教授
guest professor - 客座教授
autonomous region - 自治区
Public Relation - 公共关系学
Operational Research - 运筹学
research society - 研究会
family status - 家庭状况
marital status - 婚姻状况
foreign student - 外国学生
graduate student - 研究生
educational system - 学制
exploit  - 开发（资源，产品）
eliminate  - 消除
boar - 雄猪,种猪
calf - 小牛,牛犊
crayfish - 小龙虾,喇蛄
make - 制造
koala - 考拉,树袋熊
professional - 职业经历
mullet - 乌鱼,黑鱼
lengthen - 延长
guide - 指导；操纵
replace - 接替，替换
master - 小学校长（美）
Financial Accounting - 财务会计
Management Accounting - 管理会计学
physical activities - 体育活动
recreational activities - 娱乐活动
social activities - 社会活动
affiliated enterprise - 关联企业
agate line - 广告单位
admiralty law - 海事法
alkali soil - 碱性土壤
affiliate with - 交往
adhesive tape - 胶带
align with - 结盟
all out - 竭尽全力
abstain from - 戒
alarm call - 紧急号
alarm bells - 警铃
alcohol burner - 酒精灯
alcoholic fermentation - 酒精发酵
absolute space - 绝对空间
absolute zero - 绝对零度
absolute pressure - 绝对压强
absolute value - 绝对值
absolute monarchy - 君主专制政体
air time - 开始时间
air service - 空军
air wing - 空军部队
air base - 空军基地
air power - 空军力量
air conditioner - 空气调节机
air conditioning - 空气调节装置
air cleaner - 空气过滤器
air cooler - 空气冷却器
air jet - 空气喷射
air bath - 空气浴
air brick - 空心砖
air parcel - 空运
aerial warfare - 空战
air vent - 气孔
air cell - 气囊
air bubble - 气泡
all and sundry - 全部
an aerial survey - 航空测量
aegean sea - 爱琴海
ad valorem - 按价
after hours - 办公时间后
all thumbs - 笨拙
achievement test - 成绩测验
accept of - 承兑
admit to - 承认
abstract method - 抽象方法
abstract class - 抽象类
absolute music - 纯音乐
ad hominem - 从个人出发
access time - 存取时间
air bus - 大型客机
frighten  - 使骇怕,使吃惊,恐吓做...,突然骇怕,震惊,恫,
frisk  - 乱跳,欢闹,活跃,欢跃,蹦跳,轻摇,
frontier  - 国境,开拓与未开地之交界地方,边境,未知的领域,限界,边疆,边陲,裔,陲,
fruitless  - 不结果的,不长果实的,无子的,无效果的,无益的,不结果,
Full  - 全部,充满的,完全的,丰富的,完美的,丰满的,详尽的,完全地,整整,
funeral  - 葬礼,出殡行列,告别式,该做的事,讨厌的工作,埋葬的,葬礼用的,丧礼时的,丧,
furnace  - 熔矿炉,炉,火炉,暖气闭锁炉,灼热的地方,严格的锻链,
fury  - 激怒,热狂,猛烈,复仇三女神之一人,冤魂,泼妇,悍妇,忿怒,暴怒,
gab  - 饶舌,爱说话,多嘴,空谈,瞎扯,唠叨,
gaiety  - 愉快,快活,高兴,欢乐,狂欢,华美,
gale  - 强风,疾风,暴风,微风,薰风,狂喜,欢乐,爆发,杨梅科灌木,
gall  - 胆汁,苦味,憎恶,水彩用透明液体,五倍子,擦伤,使焦急,使怒,浸五倍子液,
gallery  - 看台,特别席,通俗趣味,回廊,画廊,摄影场,船尾展望台,坑道,长廊,
gammon  - 腌猪后腿,胡说,腌,欺骗,作假,胡说八道!,
gang  - 一群,匪帮,夥伴,运动相连串的一套机械,集体行动,集体袭击,组成一套,帮派,帮,
gap  - 空地,龃龉,间隔,山峡,上下机翼间隔,使成裂口,造成裂缝,差距,空白点,
garrison  - 守备队,驻军,要塞,驻扎地,布置守备队,派兵驻守,使当守备队镇守,警备,戍,
gay  - 快乐的,高兴的,快活的,华美的,五光十色的,淫荡的,轻浮的,春,欢乐,
generically  - 关于属类,属类地,属类上,
gentamycin  - 正大霉素,庆大霉素,正泰霉素,
gigantic  - 巨人般的,巨大的,惊人之大的,庞大的,巨,巨大,
ginger  - 生姜,姜根,精力,精神,刺激,赤黄色,使带姜味,使精神充沛,姜,
glare  - 公会,协会,同业公会,基尔特,瞪视,强光,
glaze  - 镶玻璃,上釉,弄光滑,加馅,涂透明,半透明颜料,变无神气,雨冰,装玻璃,
gloat  - 满足地看,独自暗笑,贪婪地盯,贪婪的盯视,满足的注视,幸灾乐祸,
Global  - 通用的,全球的,全世界的,球形的,综合的,普遍的,
Glossary  - 图文集,词汇,术语,字典,辞典,词汇表,
gluey  - 胶的,胶质的,粘着的,
gluttonous  - 暴食的,贪吃的,饕餮的,馋,餮,饕,
gnarl  - 节,瘤,生节,咆哮,使有节,扭,
flyer  - 飞鸟,飞行物,飞行员,快车,传单,飞跳,
foam  - 泡沫,涎沫,汗珠,海,起泡沫,口出泡沫,起泡沫而溢出,使起泡沫,沫,
folder  - 夹,文件夹,折叠人,折纸机,折叠式书本,卷宗,
footle  - 梦话,呓语,呆话,说呆话,做笨事,白费时间,
forbear  - 节制,控制,谨慎抑制,忍受,忍耐,容忍,
forehead  - 额,前额,前部,额头,颅,颡,
foremost  - 最初的,最先的,第一流的,头位的,主要的,在最前面,
forest  - 森林,山林,林野,造林,使长满树林,使成森林,林,森,树林,
foretell  - 预言,预告,预示,成为...的预兆,卜,预卜,
forever  - 永远地,常,永远,长,永,永久,
forget  - 忘记,遗忘,遗漏,看漏,说漏,怠慢,忽视,轻忽,谖,
fork  - 叉,耙,草叉,岔路,调音叉,分支,用耙子处理,使用叉子,叉子,
formerly  - 从前,以前,尝,昔日,以往,原来,
formula  - 公式,式,客套语,处方,烹调法,信仰告白书,信条,程,程式,
forswear  - 发誓抛弃,发誓否定,作伪证,
forth  - 向前,在前方,往前,向外,往看得见的地方,往户外,
fortifier  - 使坚固的人,强化物,筑城者,
fortnightly  - 半月刊,每两星期一次的,隔周发行的,隔周出版物,隔周,每两星期一次地,
forwardness  - 急切,热心,早熟,
found  - 打基础,使根据于,创立,立,铸,熔,基于,依存于,发现成立,
capital flight - 资本外逃
capital allocation - 资金划拨
capital adequacy ratio - 资本充足率
capacity to earn foreign exchange through exports - 出口创汇能力
canopy - 华盖
campus culture - 校园文化
Cameraman - 摄影师
caller ID - 来电显示
call forwarding - 呼叫转移
cable television - 有线电视
by-election - 补缺选举
buy into - 入股
bull market - 多头市场
build a socialist country under the rule of law - 建设社会主义法治国家
Buddhist scriptures - 佛经
Chinese Academy of Sciences - 中国科学院
Chinese Academy of Engineering - 中国工程院
China Unicom - 中国联通公司
China Seismological Bureau - 中国地震局
check the price - 抑制价格
Chairman - 主席
Chairman - 董事长
chafing dish - 火锅
Certified Public Accountant - 注册会计师
certified public accountant - 会计师
cash flow - 现金流量
cash cow - 摇钱树
Carry forward and cultivate the national spirit - 弘扬和培育民族精神
carpool - 拼车
carnation - 康乃馨
Captain - 领班
combined operation - 合业经营
combat smuggling - 打私
collective economy - 集体经济
clearing bank - 清算银行
clearance sale - 清仓处理
clean energy - 清洁能源
civil servants - 公务员
civil servant - 公务员
civil procedure - 民事诉讼
civil affair - 民政
circumvention - 规避
China Securities Regulatory Commission (CSRC) - 中国证券监督管理委员会
China Mobile - 中国移动通信公司
China Foundation for Poverty Alleviation - 中国扶贫基金会
child prodigy - 神童
chief justice - 大法官
chief judge - 庭长
Chief Judge - 审判长
complete monopoly - 完全垄断
advanced - 高级的
aerialist - 高空杂技师
alp - 高山
alt - 高音
alme - 歌女
all-party - 各党派的
affiche - 公告
affront - 公开侮辱
acknowledged - 公认的
admitted - 公认的
Afrikaans - 公用荷兰语
aggress - 攻击
admiral - 海军上将
allopatric - 发生的
addresser - 发信人
amerce - 罚款
agonise - 烦恼
agonising - 烦恼的
adversative - 反意的
albedo - 反照率
alibi - 犯罪现场
affine - 仿射
accessing - 访问
amplify - 放大
actinomycosis - 放射菌病
aeroplane - 飞机
airplane - 飞机
airstrip - 飞机跑道
airship - 飞艇
airmanship - 飞行术
all-important - 非常重要的
alogical - 非逻辑的
accusatory - 非难的
amuck - 疯狂地
alveolate - 蜂窝状的
adulate - 奉承
aerosol - 浮质
addled - 腐坏的
agnate - 父系
affixation - 附加
additive - 附加的
adrate - 附加税
affix - 附加物
add-in - 附加项
accessories - 附件
accessory - 附件
Add-ons - 附件
addenda - 附录
accessary - 附属的
accessorial - 附属的
Calculus - 微积分
apron - 围裙
authorized - 委任的，核准的
authorized - 委任的；核准的
bathroom - 卫生间
failure - 未考好
cozy - 温馨的
 literature - 文学
commissary in charge of entertainment - 文娱委员
Clerk - 文员（文书）
mosquito net - 蚊帐
snail - 蜗牛
bedroom - 卧室
bedroom - 卧室，寝室
property management  - 物业管理费
rhinoceros - 犀牛
primary school teacher - 小学老师
pupil - 小学生
effect - 效果，作用
president - 校长
rector - 校长
association - 协会
psycology - 心理学
liberal - 心胸宽大的
painstaking - 辛勤的，苦干的，刻苦的
Messenger - 信差（邮递员）
albatross - 信天翁
orangutan - 猩猩
storage room - 行李仓
baggage elevator - 行李电梯
name - 姓名
sex - 性别
gander - 雄鹅
tom - 雄火鸡
stallion - 雄马
ram - 雄绵羊
bull, ox - 雄牛
Sahara Desert - 撒哈拉大沙漠
sardine - 沙丁鱼
sofa - 沙发
expressive - 善于表达
analytical - 善于分析的
design - 设计
devise - 设计，发明
establish - 设立（公司等）；使开业；确立
social science - 社会科学
sociology - 社会学
application form - 申请表
height - 身高
Audit - 审计学
affectation - 假装
amour - 奸情
acuate - 尖的
acid-tongued - 尖刻的
acrid - 尖刻的
acutely - 尖锐地
adamancy - 坚硬
adamant - 坚硬
allay - 减轻
alleviate - 减轻
alkali - 碱
alkaline - 碱的
alkalosis - 碱毒症
alkalinity - 碱度
all-out - 竭力的
acariasis - 疥癣
adaxial - 近轴的
aggression - 进攻
acrocarpous - 茎端结实的
aghast - 惊骇的
amazing - 惊异的
accuracy - 精确
accurately - 精确地
alarm - 警报
alertness - 警戒
agonistic - 竞赛的
alcohol - 酒精
alcoholism - 酒精中毒
alm - 救济品
accession - 就职
ammonite - 菊石
absoluteness - 绝对
airfreight - 货物空运
acquire - 获得
acquisition - 获得
ageratum - 藿香
aerodrome - 机场
airframe - 机身
airfoil - 机翼
actin - 肌动蛋白
accumulate - 积聚
accumulative - 积聚的
amassment - 积蓄
activate - 激活
activating - 激活
actuator - 激励者
activize - 激起
ad-lib - 即兴表演
admirably - 极好地
allegro - 急速地
refine - 精练，精制
smart - 精明的
mastered - 精通的
whale - 鲸
coffee table - 咖啡台
launch - 开办（新企业）
develop - 开发，发挥
opening ceremony - 开学典礼
examiner - 考试者
oven - 烤箱
available - 可到职
dependable - 可靠的
reliable - 可信赖的
living room - 客厅
road - 路
hinny - 驴骡
supervisor - 论文导师
sunfish - 翻车鱼
translate - 翻译,转化
worker ant - 工蚁
public school - 公立学校
briefcase - 公文包
block of flats - 公寓楼
supply - 供给,满足(需要
humble - 恭顺的
hook - 钩子
tuatara - 古蜥蜴
consultant - 顾问
razor - 刮胡刀
plumber - 管道工
administer - 管理
sporting - 光明正大的
turtle - 龟
escalator - 滚梯
citizenship - 国籍
domestic flight - 国内航班
sea urchin - 海胆
contemplative - 好沉思的
kind-hearted - 好心的
qualified - 合格的
flatmate - 合住一套公寓的人；合租者
amiable - 和蔼可亲的
beaver - 河狸
hippopotamus - 河马
lane - 胡同，巷
butterfly - 蝴蝶
conditioner - 护发素
wasp - 黄蜂,胡蜂
locust - 蝗虫
recover - 恢复；弥补
all one to - 都一样
act up to - 遵守
always on top - 总在最上面
a clinging vine - 依赖男人的
act of war - 战争行为
a great way - 差得远
all the way - 一直
all the while - 一直
alice in wonderland - 爱丽丝奇境记
a bad word - 猥亵话
a household word - 人人皆知的词语
after a little - 过了一会儿
all day long - 整天
all night long - 整夜
a fat lot - 很少
a great lot - 大量
a job lot - 批发的货
a best man - 男傧相
absence of mind - 心不在焉
a pair of - 一双
a quarter of - 四分之一的
a series of - 一连串
a set of - 一组
a sheet of - 一张
a sort of - 一种
a spot of - 少量的
a succession of - 一连串
a variety of - 多种的
a wealth of - 很多的
a day off - 休息日
all too often - 时常
all at once - 突然
a way out - 摆脱的方法
a beaten path - 惯例
a hundred percent - 百分之百
all to pieces - 完全地
a hot potato - 棘手的问题
a heavy purse - 富裕
a light purse - 贫困
an unknown quantity - 未知量
an open question - 未解决的问题
a rat race - 激烈的竞争
a narrow squeak - 侥幸的脱险
a blue moon - 不可能的事
all the more - 更加
a back number - 过期的刊物
a tough nut - 大胆果断的人
against all odds - 不计成败
an amount of - 许多
a bit of - 一点
admitted - 公认的
Afrikaans - 公用荷兰语
aggress - 攻击
admiral - 海军上将
allopatric - 发生的
addresser - 发信人
amerce - 罚款
agonise - 烦恼
agonising - 烦恼的
adversative - 反意的
albedo - 反照率
alibi - 犯罪现场
affine - 仿射
accessing - 访问
amplify - 放大
actinomycosis - 放射菌病
aeroplane - 飞机
airplane - 飞机
airstrip - 飞机跑道
airship - 飞艇
airmanship - 飞行术
all-important - 非常重要的
alogical - 非逻辑的
accusatory - 非难的
amuck - 疯狂地
alveolate - 蜂窝状的
adulate - 奉承
aerosol - 浮质
addled - 腐坏的
agnate - 父系
affixation - 附加
additive - 附加的
adrate - 附加税
affix - 附加物
add-in - 附加项
accessories - 附件
accessory - 附件
Add-ons - 附件
addenda - 附录
accessary - 附属的
accessorial - 附属的
adjunct - 附属的
adjunctive - 附属的
affiliated - 附属的
anabiosis - 复苏
ad. - 副词
adverb - 副词
activator - 催化剂
acne - 痤疮
aloud - 大声地
Judicial Policeman - 法警
Judge - 审判员
joint stock company - 参股公司
joint account - 联名存款帐户
job-hopping - 跳槽
job training - 职业培训
Jiuquan Satellite Launch Centre - 酒泉卫星发射中心
jingle - 广告词
jihad - 圣战(伊斯兰教徒对异教徒的战争)
jigsaw - 拼图
iron rice bowl - 铁饭碗
investor confidence - 投资信心
investor - 股民
investment environment - 投资环境
Intranet - 内联网(计算机)
Home theater - 家庭影院
initial public offering (IPO) - 首次公开发行的股票
initial funding - 启动基金
less developed areas - 欠发达地区
Leo - 狮子座
Legislative Council - 立法委员会
legal representative - 法人代表
legal environment - 法制环境
leasing - 出租业务
leasing - 租赁
league match - 联赛
leading position - 基础地位
leading enterprise; flagship of the industry - (行业中的)龙头老大
Lawyer - 律师
law of the jungle - 弱肉强食法则
Law Committee - 法律委员会
launching ceremony - 下水典礼
rice noodles - 米粉
retail - 散户
restructuring of enterprise - 企业改制
responsibility system - 责任制
respiratory failure - 呼吸衰竭
residence booklet - 户口簿
reserve funds - 储备基金
reserve fund - 备用资金
research results - 研究成果
Research Associate - 助理研究员
Research Assistant - 研究实习员
rescue workers - 救援人员
Registrar - 注册主管
registered permanent residence - 户籍所在地
registered capital - 注册资本
safe driving - 安全行车
sado - 茶道
rural credit cooperatives - 农村信用社
all-embracing - 包括一切的
all-inclusive - 包括一切的
afterbirth - 胞衣
actuary - 保险统计
advices - 报道
aggro - 暴力
actionless - 不采取行动的
adless - 不登广告的
agnostic - 不可知论者
ageless - 不老的
ahimsa - 不杀生
airproof - 不通气的
adversity - 不幸
acidly - 不悦地
absent - 不在的
expand domestic demand - 扩大内需
euthanasia - 安乐死
European Commission - 欧洲委员会
ethnocentrism - 民族优越感
escort - 伴宴人员
equity capital - 股本金
epicenter - 震中
environmental pollution - 环境污染
environmental greening - 环境绿化
environmental benefits - 环境效益
enterprise group - 企业集团
engineering company - 工程公司
engineer - 实验师
engineer - 工程师
engineer - 畜牧师
energy-efficient - 高效节能
endowment insurance - 老年保险制度
encrypt - 加密
face value - 面值
extramarital love affair - 婚外恋
extinct species - 灭绝的物种
external environment - 外部环境
extensive management - 粗放式管理
express mail - 邮政快件
express delivery - 快递
Experimentalist - 实验师
expansionism - 扩张主义
expand domestic demand - 扩大国内需求
exclusivism - 排外主义
exclusive agency - 独家代理
exchange ratio - 外汇比价
exchange rate - 汇率
peaceful evolution - 和平演变
Everything goes well - 吉祥如意
Everything comes to him who waits. - 功夫不负有心人
Dioxin - “二恶英”
semiconductor material - 半导体材料
Electronic Cash - 电子现金
abluent - 洗洁剂
ablution - 清洗
ably - 能干地
ABM - 反导弹
abnormality - 反常
abnormally - 反常地
abnormity - 异常
aboveground - 在地上
above-mentioned - 上述的
abrade - 磨损
Abraham - 亚伯拉罕
abranchial - 无鳃的
abrasion - 擦破
abrasive - 磨损的
abraxas - 避邪字
abreact - 消散
abreast - 并肩地
abri - 避难所
abridge - 剥夺
abridged - 省略的
abridgement - 删节
abroad - 往国外
abrogate - 废除
abrogation - 废除
abrupt - 突然的
abruption - 中断
abruptly - 突然地
abruptness - 突然
abscessed - 长脓疮的
ALGOL - Algol语言
A-OK - 极好
A-side - A面
put up a fight - 奋勇战斗，抵抗
blockbuster - 热门电影
action thriller - 动作片
pounce on - 抨击
information materials - 信息材料
IT Outsourcing - 信息技术外包
Virtual Reality Technology - 虚拟现实技术
abductor - 绑架者
Abe - 亚伯
abecedarian - 初学者
abed - 在床上
abele - 银白杨
aberrance - 脱离正道
aberrant - 异常的
abet - 教唆
adaptive - 适应的
acclimation - 适应环境
acclimatization - 适应环境
acculturate - 适应文化
adaptability - 适应性
adjustability - 适应性
acidophilic - 嗜酸的
amiable - 亲切的
aggrieve - 侵害
aggressively - 侵略地
aggressor - 侵略者
admiration - 钦佩
adolescence - 青春期
amboyna - 青龙木
alist - 倾斜的
albumin - 清蛋白
affectivity - 情感作用
agar - 琼脂
AMor - 丘比特
allotype - 球蛋白
ametropia - 屈光异常
acranial - 缺颅骨的
absentee - 缺席者
afterward - 然后
afterwards - 然后
aflame - 燃烧的
afire - 燃烧着
alienator - 让渡者
admit - 容许
acceptant - 容易接受的
amalgamation - 融合
admittance - 入场
acuminate - 锐利的
alkalescence - 弱碱性
alkalescent - 弱碱性的
amanita - 伞形毒菌
alexin - 杀菌素
amok - 杀人狂
agitation - 煽动
agitator - 煽动者
amphibole - 闪石
accompany - 陪伴
accompaniment - 陪伴物
amends - 赔偿
amigo - 朋友
affirmation - 批准
amice - 披肩
amphipod - 片脚类动物
adrift - 漂浮着
afloat - 飘浮的
available - 可到职
dependable - 可靠的
reliable - 可信赖的
living room - 客厅
road - 路
hinny - 驴骡
supervisor - 论文导师
sunfish - 翻车鱼
translate - 翻译,转化
worker ant - 工蚁
public school - 公立学校
briefcase - 公文包
block of flats - 公寓楼
supply - 供给,满足(需要
humble - 恭顺的
hook - 钩子
tuatara - 古蜥蜴
consultant - 顾问
razor - 刮胡刀
plumber - 管道工
administer - 管理
sporting - 光明正大的
turtle - 龟
escalator - 滚梯
citizenship - 国籍
domestic flight - 国内航班
sea urchin - 海胆
contemplative - 好沉思的
kind-hearted - 好心的
qualified - 合格的
flatmate - 合住一套公寓的人；合租者
amiable - 和蔼可亲的
beaver - 河狸
hippopotamus - 河马
lane - 胡同，巷
butterfly - 蝴蝶
conditioner - 护发素
wasp - 黄蜂,胡蜂
locust - 蝗虫
recover - 恢复；弥补
crib - 夹带(美作:trot)
homework - 家庭作业
tariff - 价目表
skipjack - 鲣鱼
shorten - 减低......效能
reduce - 减少，降低（成本等）
simplify - 简化,精简
Architect - 建筑师
architecture - 建筑学
health - 健康状况
imply  - 暗指,含...意,意味,含蓄,包含,暗示,含有,暗含着,意味着,
imputation  - 归罪,负责,责难,
inadequate  - 不适当的,不十分的,未成熟的,不够,不适当,不足,
inasmuch  - 因此...,由于...,只要...,因此,因...之故,因┅之故,
incite  - 唆使,斗,煽,唆,挑,挑起,恿,嗾,竦,
incredible  - 不能采信的,不能信用的,难以相信的,不可思议的,难以置信的,难以置信,
incumbency  - 在职,义务,在职期间,
indefinite  - 不确定的,模糊的,不明了的,不一定的,无限的,无期限的,不明确的,不定,不明确,
independence  - 独立,自主,自立,独立心,可维持独立生活之收入,独立性,
independent  - 独立的,自主的,大胆的,自食其力的,独立者,无党派人士,独立教会主义者,独,独立,
index  - 索引,引得,指示物,食指,指数,禁书目录,指标,编索引,索引指数,
indifference  - 不关心,不在乎,冷淡,不重要的事,细微的事,不重视,
indiscriminate  - 无差别的,不分皂白的,杂陈的,
infatuation  - 迷惑,迷恋,醉心,
infer  - 推理,推论,推断,表示,意味,含有...意味,
inference  - 推理,推断,推论的结果,结论,推论,论断,
infest  - 群袭,爬满,在...出没,蹂躏,横行,扰乱,
infinite  - 无限的,庞大的,无数的,不定的,无限大的,无限,无限物,无限空间,项,
infinitesimal  - 极小的,极微的,无限小的,极小量,极微量,无限小,
influence  - 影响,作用,感化力,权势,有影响力的人,感应,发生影响,改变,势,
inform  - 通知,报告,鼓吹,充满,告发,密告,报信,达,诜,
ingenuity  - 发明才能,贤明,聪明,巧妙,精妙,创造力,
ingress  - 进入,入口,准许进入,
fraud  - 欺骗,欺诈,欺诈行为,**,假东西,弊,骗局,舞弊,作弊,
gnarly  - 多节的,粗糙的,执拗的,
goody  - 身分低微之老妇,媪,糖果,感伤的,伪善的,太好了,
goof  - 呆子,傻瓜,弄糟,混,打发时间,出大错,
gout  - 味,趣味,嗜好,痛风,一滴,一团,
grab  - 突攫,抓握,抢去,略夺的行为,攫取机,起重钩,小孩的纸牌游戏之一种,抓,抓住,
grandeur  - 壮伟,庄严,壮观,伟观,伟大,崇高,威严,威风,高贵,
grasshopper  - 蚱蜢,蝗虫,蟋蟀之类,小型侦察机,蚂,蚱,蛩,蜢,蠓,
grassy  - 草深的,像草的,绿色的,如草的,如草,萃,
grate  - 炉架,炉,铁栅栏,选矿筛子,装铁栅栏于,擦碎,互磨擦,轧,使刺激神精,
gravel  - 碎石,砂砾层,肾砂,铺碎石,使搁浅在碎石滩上,使困惑,因碎石而受伤,砾,砂,
gravy  - 闪耀,刺眼,怒目而视,瞪眼,镜般光滑的表面,光滑而发亮的,肉汁,调味肉汁,卤,
greenery  - 绿叶,绿树,装饰用的绿树枝或叶,
greet  - 致候,致敬,迎接,看得到,听得到,闯进,哭,叹,悲伤,
grieve  - 使悲伤,使苦恼,使伤心,悲伤,悲叹,伤心,
grip  - 紧握,特殊握手方法,把手,支配,领悟力,旅行包,剧痛,扣住,握住,
grizzle  - 灰色,灰色物,斑白的发,变成灰色,发脾气,使成灰色,
grocery  - 食品杂货,食品杂货店,杂货,
groom  - 马夫,新郎,属英国宫内的侍从官,下男,修整,照顾,教育,训练,使准备,
growl  - 吠声,不平,咆哮声,怒吠,咆哮,吼,鸣不平,隆隆作响,咆哮著说,
guest  - 客人,来宾,旅馆等投宿的客人,寄生动物,宾,客,
guidance  - 向导,指导,学生指导,辅导,指挥,指示,
guiltless  - 无辜的,没罪的,不知...,对...无经验的,不拥有,具有...的,
gum  - 胶,套靴,橡皮糖,眼屎,牙床,...的变形,涂以树胶,骗,分泌树胶,
gun  - 炮,枪,大炮之发射,狩猎队之一员,小偷,烟斗,用枪打,取猎,加快速度,
gunmen  - 枪手,持枪的歹徒,制造枪械者,
Gutter  - 装订线,排水沟,槽,贫民区,开沟于,流,
Annual - 年鉴，年度
Abstracts - 文摘
Institute - 学会、研究所
Dissertations - 学位论文
Journal - 杂志、刊
Symposium - 专题学术讨论会
Encyclopedia - 百科全书
Semi-Annual - 半年度
Gazette - 报，公报
Heading - 标题词
Press - 出版社
Classification - 分类，分类表
Keyword - 关键词
Transactions - 汇报、汇刊
Record - 记录、记事
Advances - 进展
Progress - 进展
Topics - 论题、主题
Papers - 论文
Directory - 名录，指南
Content - 目次
List - 目录、一览表
Yearbook - 年鉴
Title - 篇名、刊名、题目
Review - 评论、综述
Issue - 期（次）
Handbook - 手册
Manual - 手册
Bibliography - 书目，题录
Abbreviation - 缩语和略语
Index - 索引
Summary - 提要
Bulletin - 通报，公告
Archives - 文献集
Thesaurus - 叙词表、词库
Acta - 学报
Guide - 指南
Subject - 主题
Author - 作者
Electronic Data Interchange   - 电子数据交换
For your information   - 供参考
With respect to   - 关于
Be right back   - 很快回来
By the way   - 随便说一下
I love you   - 我爱你
See you later   - 下次再会
Domain Name System   - 域名系统
Free on Board   - 装运港船上交货价
For example    - 举例
girlfriend     - 女朋友
lipase - 脂酶
lipoblastoma - 脂胚细胞瘤
rectum - 直肠
flora - 植物区志；细菌丛
phytotron - 植物人工气候室
antitussive - 止咳的；止咳剂
analgetic - 止痛剂；止痛的
digit - 指；趾
shigellosis - 志贺杆菌病
Shigella - 志贺杆菌属
therapy - 治疗
plasmid - 质体
oo- - 与「卵」有关之字首
pre- - 与「前面」有关之字首
bio- - 与「生命」有关的字首
biotic - 与「生物」、「生命」有关
oxy- - 与「氧化」、「酸化」、「敏锐」有关之字首
iatro- - 与「医师」、「医学」有关之字首
ex- - 与「由……出来」、「除外」、「完全」、「之前为……」有关之字首
phyto- - 与「植物」有关之字首
ad- - 与「至」、「向」、「近」有关之字首
peri- - 与「周围」有关之字首
levo- - 与「左旋的」有关之字首
breeding - 育种；繁殖
preconditioning - 预处理
prevention - 预防
prophylaxis - 预防
caveat - 预告
prognosis - 预後
verruca - 疣
wart - 疣
organophosphate - 有机磷
appetitive - 有食慾的
mitosis - 有丝分裂
conditioned - 有条件的；条件的
gametogenesis - 有性生殖
syngenesis - 有性生殖
nymph - 幼虫
neoteny - 幼龄延长；稚龄延长
fawn - 幼鹿；小动物；小山羊
inducer - 诱导体；诱发体
spinner - 诱饵
protamine - 鱼精蛋白
schizo- - 与「分裂」有关之字首
photo- - 与「光」有关之字首
translocation - 移位
transplantation - 移植
transplant - 移植；移植物
hereditary - 遗传性的
ethyl - 乙基
negative growth - 负增长
Ministry of Personnel - 人事部
Ministry of Information Industry - 信息产业部
Ministry of Foreign Affairs - 外交部
Ministry of Finance - 财政部
Ministry of Education - 教育部
Ministry of Culture - 文化部
Ministry of Construction - 建设部
Ministry of Communications - 交通部
Ministry of Civil Affairs - 民政部
Ministry of Agriculture - 农业部
minister without portfolio - 不管部部长
mining right - 开采权
minibus - 小巴
mineral resources - 矿源
millennium bug - 千年问题、千年虫
military court - 军事法院
military confrontation - 军事对峙
militarily competent - 军事过硬
metaphysics - 形而上学
merger - 联合；合并
Mencius - 孟子
meet-and-greet - 见面会
medical insurance - 医疗保险
media - 传媒
mechanical and electrical products - 机电产品
Mechanic - 机械师
nuclear family - 核心家庭
non-aligned movement - 不结盟运动
noise abatement - 噪声治理
nirvana - 涅磐(佛)
nine-year compulsory education - 九年义务教育
night life - 夜生活
niche - 利基
NHK - 日本广播协会
new issues - 新发行股票
neutron bomb - 中子弹
networking - 网络化
net friend - 网友
net ball - 擦网球
natural rights - 天赋人权
nationwide census - 全国人口普查
National Tourism Administration - 国家旅游局
national economic census - 全国经济普查
National Committee of the Chinese People's Political Consultative Conference (CPPCC) - 中国人民政治协商会议全国委员会（简称全国政协）
national cohesion - 民族凝聚力
nation state - 民族国家
nanometer - 纳米
mycoplasma - 支原体
mutual funds - 共同基金
Translator - 翻译员
bath mat - 防滑垫
real estate - 房地产
landlord - 房东
landlord - 房东；（旅馆、家庭公寓等的）主人，老板
housing price - 房价
room rate - 房价
House Leasing Contract - 房屋合同
grades - 分数
analyze - 分析
queen bee - 蜂王
swallowtail - 凤尾蝶
anchovy - 凤尾鱼
counselor - 辅导老师
minor - 辅修
assist - 辅助
attached middle school - 附中
Easter Island - 复活节岛
vice-president - 副会长
minor - 副修
creative - 富创造力的
reform - 改革
innovate - 改革，革新
improve - 改进，提高
higher education - 高等教育
senior high school - 高中
enliven - 搞活
business administration - 工商管理
recommended - 被推荐的；被介绍的
required course - 必修课
to graduate - 毕业
name tag - 标有姓名的标签
letter of recommendation - 表扬信
alias - 别名
persevering - 不屈不挠的
Finance - 财政学
born - 出生于
elementary education - 初等教育
primary education - 初等教育
junior high school - 初中
kitchen - 厨房
cupboard - 橱柜
sheet - 床单
bedside table - 床头柜
create - 创造
set - 创造（纪录等）
dryer - 吹风机
bitch - 雌狗
cow - 雌牛,母牛
nanny - 雌山羊
sea urchin - 海胆
contemplative - 好沉思的
kind-hearted - 好心的
qualified - 合格的
flatmate - 合住一套公寓的人；合租者
amiable - 和蔼可亲的
beaver - 河狸
hippopotamus - 河马
lane - 胡同，巷
butterfly - 蝴蝶
conditioner - 护发素
wasp - 黄蜂,胡蜂
locust - 蝗虫
recover - 恢复；弥补
crib - 夹带(美作:trot)
homework - 家庭作业
tariff - 价目表
skipjack - 鲣鱼
shorten - 减低......效能
reduce - 减少，降低（成本等）
simplify - 简化,精简
Architect - 建筑师
architecture - 建筑学
health - 健康状况
paste - 浆糊
lecturer - 讲师
rewards - 奖励
scholarship - 奖学金
glue - 胶水
adhesive tape - 胶条
 algebra - 代数
double room - 带一张双人床的房间
on change - 待清扫房
tortoise - 玳瑁
single room - 单人间
mussel - 淡菜,贻贝
registration - 登记
carpet - 地毯（一般指大的整块的，铺房间的那种）
rug - 地毯（一般指小块的，放在沙发等边上的那种）
address - 地址
first floor - 第二层
ground floor - 第一层
electric fan - 电扇
electric iron - 电熨斗
electronic engineering - 电子工程学
Circuitry - 电子线路
cushion - 垫子
research - 调查，研究
dish - 碟子
reservation - 订房间
listed companies - 上市公司
Line! - 压线(口令)
line of products - 系列产品
limited liability company - 有限责任公司
limited liability company - 股份有限公司
like product - 同类产品
lighting - 采光
life expectancy - 预期寿命
license plate number - 车牌号
Internet bar - 网吧
international commitments - 国际承诺
interim measure - 暂行办法
interface - 接口
interest-free loan - 无息贷款
intercontinental ballistic missiles - 洲际弹道导弹
inter-bank borrowing - 同业拆借
marginal return - 边际报酬
marginal benefit - 边际效益
margin account - 保证金帐户
make arrangements - 操办
make a fresh start - 另起炉灶
mainstay of the economy - 主体经济
mail-order service - 邮购服务
mail-order - 邮购
macro-control - 宏观调控
luxury car - 豪华轿车
low-cost housing - 经济房
Love me, love my dog. - 爱屋及乌
lottery ticket - 彩票
local war - 局部战争
local police station - 派出所
local calls - 市话
mass organizations - 各人民团体
mascot - 吉祥物
market-oriented - 以市场为导向
marketization - 市场化
marketing - 营销
marketing - 市场营销学
market regulation - 市场调节
market orientation - 市场导向
market on commission - 代销
market expansion - 扩容
management system - 经营责任制
male chauvinism - 男权主义思想
make hay while the sun shines - 莫失良机;趁热打铁
negative mentality - 逆反心理
negative growth - 负增长
Ministry of Personnel - 人事部
Ministry of Information Industry - 信息产业部
Ministry of Foreign Affairs - 外交部
acceptor - 接受者
abstinence - 节制
aftermath - 结果
agglomeration - 结块
ally - 结盟
algal - 海藻的
agued - 害疟疾的
afraid - 害怕
ambiguity - 含糊
alcoholic - 含酒精的
algidity - 寒气
airways - 航空公司
across - 横过
abscissa - 横坐标
aftereffect - 后效
ampullae - 壶腹
aleurone - 糊粉
amber - 琥珀
amidate - 化为醯胺
ambidexterity - 怀二心
ambidextrous - 怀有二心的
acclamation - 欢呼
alleviation - 缓和
amble - 缓行
absurdity - 荒谬
absurd - 荒谬的
absurdly - 荒谬地
aflatoxin - 黄曲霉毒素
aftertaste - 回味
accountant - 会计
accounting - 会计
agglutinative - 会胶合的
admix - 混合
admixture - 混合
activation - 活化
activity - 活跃
actively - 活跃地
alive - 活着的
accelerometer - 加速计
amalgam - 汞合金
accrete - 共生
age-old - 古老的
amphitheater - 古罗马剧场
aforethought - 故意的
advisor - 顾问
entrepreneurs - 企业家
accounting scandal - 财务丑闻
accounting fraud - 假帐
accounting computerization - 会计电算化
accountant - 会计员
a succession of - 一连串
a variety of - 多种的
a wealth of - 很多的
a day off - 休息日
all too often - 时常
all at once - 突然
a way out - 摆脱的方法
a beaten path - 惯例
a hundred percent - 百分之百
all to pieces - 完全地
a hot potato - 棘手的问题
a heavy purse - 富裕
a light purse - 贫困
an unknown quantity - 未知量
an open question - 未解决的问题
a rat race - 激烈的竞争
a narrow squeak - 侥幸的脱险
a blue moon - 不可能的事
all the more - 更加
a back number - 过期的刊物
a tough nut - 大胆果断的人
against all odds - 不计成败
an amount of - 许多
a bit of - 一点
a copy of - 一份
a couple of - 两个
a crowd of - 许多的
a handful of - 少量的
all kinds of - 各种
a list of - 一列
a little of - 少些
a lot of - 许多的
a majority of - 大部分
a mass of - 大量的
Super Girl - 超级女声
Windfall Tax - 暴利税
about-turn - 向后转
above - 上面的
motivators - 激励因素
amadan - 阿玛松
amen - 阿门
dislike  - 讨厌,嫌恶,憎恶,反感,不喜欢,惮,怼,憝,訾,
disorder  - 不检点的,混乱,骚动,失调,害病,使混乱,使失调,使害病,紊乱,
disperse  - 散,驱散,使解散,传播,分散,消散,散开,解散,轶,
disposal  - 处分,整理,转让,卖掉,处理,解决,处分的自由,配置,配列,
dissident  - 持不同政见,意见不同的,不同意的,不赞成的,意见不同的人,不赞成者,
distill  - 蒸馏,以蒸馏法制造,用蒸馏法除去,抽取,放出,滴下,
distiller  - 蒸馏者,蒸馏器,蒸馏商,
distribution  - 分配,分发,类别,分布状态,扩充,拆版,
distrust  - 不信,不信用,疑惑,猜疑,怀疑,耽心,
aggregate - 合计
aikido - 合气道
amaurosis - 黑内障
Africanization - 非洲化
adiposity - 肥胖
adiposis - 肥胖病
allocate - 分派
allocation - 分配
allot - 分配
allotment - 分配
amortisation - 分期偿还
ado - 纷扰
ambrosial - 芬香的
amidin - 粉溶素
abundant - 丰富
air-dry - 风干的
affluently - 富裕地
alvine - 腹的
alterative - 改变的
ameliorant - 改良物
ameliorate - 改善
amelioration - 改善
ameliorative - 改善的
amendatory - 改善的
airer - 干燥器
algesia - 感觉过敏
aery - 高处的巢
ALT. - 高度
altitude - 高度
altitudinal - 高度的
altimeter - 高度计
advanced - 高级的
aerialist - 高空杂技师
alp - 高山
alt - 高音
alme - 歌女
all-party - 各党派的
affiche - 公告
affront - 公开侮辱
acknowledged - 公认的
admitted - 公认的
Afrikaans - 公用荷兰语
aggress - 攻击
admiral - 海军上将
allopatric - 发生的
addresser - 发信人
amerce - 罚款
agonise - 烦恼
agonising - 烦恼的
adversative - 反意的
otter - 水獭
master - 硕士
squirrel - 松鼠
Stenographer - 速记员
pike - 梭子鱼
steady - 塌实的
sloth - 獭猴
negotiate - 谈判
ironing board - 烫衣板
raise - 提高
pelican - 鹈鹕
weight - 体重
vole - 田鼠
logical - 条理分明的
classmate - 同班同学
schoolmate - 同校同学
Statistics - 统计学
vulture - 秃鹫
condor - 秃鹰
marmot - 土拨鼠
mat - 席子
sink - 洗碗池
dishwasher - 洗碗机
mule - 骡
camel - 骆驼
toilet - 马桶
chinchilla - 南美栗鼠
gopher - 囊地鼠
competent - 能胜任的
pup - 年幼的狗
herd - 牛的统称
bullfrog - 牛蛙
agriculture - 农学
female - 女
governess - 女家庭教师
schoolgirl - 女生
drainage - 排水道
auditor - 旁听生
auditor - 旁听生（美）
penguin - 企鹅
modest - 谦虚的
squid - 枪乌贼,鱿鱼
bracket - 墙上突出之托架
herring - 青鱼,鲱
district - 区
heating - 取暖费
cancellation - 取消预定
anthropology - 人类学
recognize - 认清（职责等）
earnest - 认真的
WAN  - 苍白的,无血色的,病态的,暗淡的,广域网,广域网路,
Zero  - 零,零点,零度,无,乌有,最低点,零的,调零,对准,
lieutenant  - 代理主官,中尉,少尉,上尉,副队长,陆军中尉,
ligature  - 绳,索,缚带,缚,捆,结扎,
likeness  - 相似,类似,肖像,画像,照相,外观,外貌,姿态,相似之人,
lily  - 百合,百合花,洁白之物,白皮肤之人,纯洁之人,鸢尾花,
limitation  - 限制,限定,极限,限度,无能力,上诉期限,
linen  - 亚麻布,亚麻类,亚麻制制品,亚麻的,亚麻制的,亚麻般白色的,
linger  - 踌躇,徘徊,长久不消失,持久不衰,耽搁,拖久,挨过,留连,逗,
lip  - 唇形物,端缘,唇瓣,唇管,用嘴唇触,接吻,冲洗,嘴唇,唇,
LIP  - 唇,口缘,唇状构造,以嘴唇碰,轻轻说出,口头上的,
liquid  - 液体,流音,流动的,流动性的,澄清的,不安定的,流畅的,易变为现金的,液,
locate  - 设置,居住,找出下落,表示场所,找出出处,位于指出,
locker  - 上锁人,锁具,贮藏箱,
locomotor  - 运动的,移动的,运转的,有运动力之物,好旅行的人,移动发动机,
lodging  - 寄宿,住宿,住处,寓所,出租的房子,公寓,
log  - 圆形木材,笨蛋,测程仪,旅行日记,工作时间表,积表,砍倒,出航,日志木头,
logic  - 理论学,逻辑,理论学书,理论,论法,条理,使人无法抵抗的迫力,理,逻,
longing  - 切望,热望,憧憬,切望的,响往的,欲,
longitudinal  - 轻度的,经线的,纵的,
long-sighted  - 眼力好的,有先见之明的,卓见的,
looks  - 样子,姿,姿容,
lordship  - 贵族身份,主权,支配,所有,领地,阁下,
loudly  - 高声地,大声地,吵闹地,夺目地,粗俗地,高声,
loving  - 爱的,有爱情的,锺情的,忠良的,喜爱,缱,
lush  - 苍翠繁茂的,多青草的,丰富的,酒,醉醺醺,饮,
lusty  - 健康的,强壮的,精力旺盛的,活泼的,体格魁武之人,肥胖的,
m$  - 马来西亚币
Magnification  - 扩大,夸张,赞美,
magnify  - 扩大,映大,夸张,夸大,赞美,夸耀,
magpie  - 鹊,鸽的一种,绕舌的人,斑驳的,有收集癖的,混杂的,
maid  - 处女,未婚女子,少女,闺女,女仆,侍女,
maiden  - 处女,少女,闺女,一种断头台,未婚的,纯洁的,初次的,未赢过的,处女的,
mercury  - 水银,水银柱,温度计,晴雨计,活力,精力,山木蓝类,水星,汞,
mere  - 仅是,单单,丝毫没有别的,全然的,只是,仅仅的,
messenger  - 使者,信差,送电报的人,送公文的信差,报信者,前驱,前兆,补助索,使,
metalloid  - 象金属的,非金属的,类似金属性的,非金属,类似金属,两性金属,
metre  - 公尺,格,韵律,
mew  - 海鸥,咪咪叫,鹰笼,巢,隐匿处,放进笼里,关起来,偷换,猫叫声,
miasma  - 瘴气,氛,瘴,
midday  - 正午,白昼,中午,
midst  - 中央,正中,当中,中间,在中央,在正中,
migrate  - 迁居,迁移,转移,
military  - 或许,大概,军事,军事的,兵,军,军方,武,武装,
million  - 百万,无数,多数,百万元,百万磅,民众,大众,百万的,多数的,
millstone  - 磨石,碎器,重担,
mine  - 我的东西,我的家人,我的,矿山,坑道,秘密策略,采矿,破坏,矿,
miniature  - 缩小画,纤细画法,缩图,小型,小型的,缩图的,绘成纤细画,缩印,缩小模型,
minimal  - 最小的,极微的,最小限度的,
ministry  - 牧师之职,部长之职,圣职者们,内阁,诸部长,公使团,服侍,部门,部,
payment in advance - 预付
pay-cut - 工资削减
patent Medicine - 成药
passenger transport - 客运
Communist Party of China (CPC) - 中国共产党(中共)
pickpocket - 扒窃
photo album - 写真集
people-oriented service - 人性化服务
multinational companies - 多（跨）国公司
multimedia - 多媒体
mouthpiece - 喉舌；代言人
Mount Qomolangma - 珠穆朗玛峰
morning market - 头市
morning exercise - 晨练
moral education - 品德教育
Monroe Doctrine - 门罗主义
money-oriented - 一切向钱看
monetization - 货币化
module - 模块
modern thinking - 现代意识
modern distance education - 现代远程教育
preparatory committee - 筹备委员会
premium - 溢价
portals - 门户网站
portal - 门户网站
population density - 人口密度
popularity - 人气
pop culture - 流行文化
pop can - 易拉罐
political restructuring - 政治体制改革
pinko - 左倾
pilot project - 试点工程；试点项目
pilot project - 试点工程
pillar - 支柱产业
philosophy of life - 处世之道
pharmacist - 主管药师
pharmacist - 药师
perihelion - 近日点
percentage points - 百分点
professional evaluation - 评职
principle of equality and mutual benefit - 平等互利原则
Prince Charming - 白马王子
primary productive force - 第一生产力
price fluctuation - 价格波动
price elasticity - 价格弹性
pretty pass - 尴尬，困境，糟糕
press box - 记者席
Presidium - 主席团
President - 总裁
President - 理事长
comparative literature - 比较文学
tally company - 理货公司
common security - 共同安全
common prosperity - 共同富裕
common interests - 共同利益
commodity economy - 商品经济
current address - 目前地址
[ ]square brackets - 方括号
Management Information System - 管理信息系统
Principles of Management - 管理学原理
Principle of Mechanics - 机械原理
dean of students - 教导主任
research society  - 研究会教育程度
Principle of Marxism - 马克思主义原理
counterfeit - 仿冒
counterattack - 防守反击(足球用语)
countdown - 倒计时
Counselor - 参事
cost-effectiveness - 成本效益
cost price - 成本价`
corporate shares - 法人股
corporate culture - 企业文化
corporate bond - 公司债券
corona virus - 冠状病毒
core competitiveness - 核心竞争力
copyright law - 版权法
copycat packaging - 冒充包装（销售）[指将劣质商品包装成外观像名优产品出售的做法]
co-organizer - 协办单位
convertible bond - 可转换债券
consumer price index - 消费者物价指数
consultancy company - 点子公司
Constable - 警员
consolation prize - 安慰奖
consolation prize - 鼓励奖
consecration - 开光
Dengue Fever - 登革热
Deng Xiaoping Theory - 邓小平理论
democratic supervision - 民主监督
democracy at the grassroots level - 基层民主
demo - 演绎版
delivery - 交割
credentialism - 文凭主义
coverage rate - 覆盖率
be promoted to - 被提升为
date of birth - 出生日期
ID card No. - 身份证号码
Digital Image Processing - 数字图像处理
Microeconomics & Macroeconomics - 西方经济学
Automatic Control System - 自动控制系统
forceful - （性格）坚强的
AFB - 空军基地
air - 空气
airy - 空气的
aerodynamic - 空气动力
aerodynamics - 空气动力学
aerodynamically - 空气动力学地
aerodynamicist - 空气动力学者
aerostatic - 空气静力学的
air-cooling - 空气冷却法
airspeed - 空速
air-raid - 空袭的
airspace - 空域
airborne - 空运
airlift - 空运
amplifier - 扩音器
abuse - 滥用
aging - 老化
acrostic - 离合诗
altruistic - 利他的
altruism - 利他主义
allied - 联盟的
affiliation - 联系
alchemy - 炼金术
alchemic - 炼金术的
alchemical - 炼金术的
alchemist - 炼金术士
amativeness - 恋爱
amatory - 恋爱的
amphibious - 两栖的
aftergrowth - 两期农作物
amphoteric - 两性的
abut - 邻接
adjacency - 邻接
abutting - 邻接的
adjoining - 邻接的
adjacent - 邻近的
afflatus - 灵感
akela - 领队人
Americanization - 美国化
American - 美国人
accouterments - 军人配备
acquittal - 开释
advised - 考虑过的
adorable - 可爱的
adoptable - 可采用的
acceptability - 可接受
accredited - 可接受的
affirmably - 可肯定地
actionable - 可控告的
affable - 可亲的
DAP  - 将饵食轻放水面,跳出,轻点水面,使乱跳,弹跳,乱跳,
dare  - 敢...,胆敢...,冒,挑逗...,激,敢作,挑战,胆敢,敢,
darken  - 使暗,使暧昧,使郁闷,弄污,变黑暗,变阴郁,加深,变暗,变黑,
daylight  - 昼光,白天,黎明,明显的状态,空隙,智力,才智,白日,白昼,
dazzle  - 使眼花,使眩眼,使茫然,幻惑,耀眼,眼花撩乱,晃,曜,炫,
deadweight  - 重负,静负荷,自重,
deaf  - 聋的,耳朵重的,不听的,不理的,聋,聩,
decadence  - 腐朽,腐烂,衰退,衰败,堕落,颓废,
decelerate  - (使)减速,
dedication  - 奉献,献身,致力,题献,献辞,题词,
defense  - 防御,拥护,防御物,防御设施,城堡,辩明,被告方面,防守方面,维护,
defer  - 延缓,展期,延期,迁延,迟缓,表示敬意,服从,顺从,推迟,
deference  - 依从,听从,遵从,
deferment  - 迁延,延期,展缓,
defervescence  - 退热期,热退期,止沸,
deficient  - 缺乏,不充分的,有缺陷的,智慧不够的,痴呆的,缺乏的,短少,欠,歉,
definitely  - 定,定然,一定地,肯定地,明确地,确切地,
degradation  - 降级,降职,左迁,降等,堕落,退化,剥蚀,渐崩,免职,
deice  - 防止结冰,除冰,装以除冰装置,
deliberate  - 深思熟虑的,故意的,有计划的,慎重的,不慌忙的,从容的,谨慎的,磋,商讨,
demise  - 崩,薨,死亡,让渡,遗赠,转让,
directorial  - 指挥的,管理的,指挥者的,
disappear  - 看不见,失纵,消没,消失,消灭,失纵,消失,不见了,遁,杳,
disarray  - 弄乱,使混乱,使脱去衣服,无秩序,杂乱,不整齐的衣服,
disaster  - 灾害,惨事,天灾,不幸,倒霉运,祸,难,灾,灾难,
discourage  - 使沮丧,使丧失勇气,使打断念头,阻止,使受挫折,气馁,
discretion  - 慎重,辨别力,考虑,判断,识别,判断的自由,自由裁量,斟酌,自由裁决,
disdain  - 轻蔑,侮蔑,骄傲自大,藐视,不屑做...,以...为耻而不做,使退下,鄙弃,鄙视,
disease  - 病,不健全,弊病,变质,使害病,疾病,病症,疾,症,
disguise  - 变装,假装服,虚伪,托辞,欺骗,伪装,化装,隐藏,装模作样,
disgusted  - **,
disk  - 平圆盘,圆盘,唱片,圆盘状组织,花盘,磁碟,
cognition  - 认识,认识力,知觉,
collateral  - 并行的,附随的,旁系的,支亲,副保,附属担保物,
collator  - 对照者,校对者,整理人,
coloured  - 有彩色的,有色的,装饰的,
colt  - 小马,无经验的年轻人,新手,苔绳,用鞭绳抽打,驹,
combined  - 化合的,综合的,组合的,
comely  - 标致的,美丽的,不会丢脸的,适宜的,合适的,满意的,
comfort  - 慰藉,慰劳品,舒适,使生活舒适,被窝,帮助,安慰,使缓和,使快乐,
comical  - 滑稽的,好笑的,诙谐的,奇妙的,滑,滑稽,
coming  - 就要来的,将来的,其次的,新进的,渐露头角的,到达,发生,来临,未来,
commander  - 指挥官,司令官,海军中校,副舰长,上级勋爵,舰长,
commentary  - 注释,评论,批评,时事评论,实况录音记录,评注,
commission  - 委任状,命令,委员会,代办,任命,订制,任命为军官,使服役,佣金,
commissioner  - 委员,理事,局长,行政长官,地方行政官,职业棒球等的最高负责人,
commonplace  - 平凡的,陈腐的,老生常谈,陈腐之言,日常琐事,备忘录,记入备忘录,平凡,普遍,
communicate  - 传,传达,使改感染,给予圣餐,沟通,相通,通信,传染,接受圣餐,
comparative  - 比较的,由于比较的,比较上的,相当的,比较级的,比较级,
compassionate  - 慈,慈悲的,富于同情心的,斟酌情况的,怜悯,同情,
adult education - 成人教育
honest - 诚实的
export - 出口
Cashier - 出纳员
Physical Education - 体育
Chief Engineer - 总工程师
Sales Engineer - 销售工程师
software engineering - 软件工程
College English - 大学英语
business experience - 工作经历
research fellow - 研究员
International Finance - 国际金融
Computer Graphics - 图形学原理
professional history - 职业经历
participate in - 参加
second job - 第二职业
Contract Law - 合同法
job objective - 工作目标
sort out - 清理
business phone - 办公电话
home phone - 住宅电话
office phone - 办公电话
College Physics - 大学物理
native place - 籍贯
social practice - 社会实践
Word Processing - 数据处理
associate professor - 副教授
guest professor - 客座教授
autonomous region - 自治区
Public Relation - 公共关系学
Operational Research - 运筹学
research society - 研究会
family status - 家庭状况
marital status - 婚姻状况
foreign student - 外国学生
graduate student - 研究生
educational system - 学制
exploit  - 开发（资源，产品）
eliminate  - 消除
boar - 雄猪,种猪
calf - 小牛,牛犊
crayfish - 小龙虾,喇蛄
make - 制造
koala - 考拉,树袋熊
professional - 职业经历
mullet - 乌鱼,黑鱼
lengthen - 延长
guide - 指导；操纵
replace - 接替，替换
master - 小学校长（美）
aggress - 攻击
admiral - 海军上将
allopatric - 发生的
addresser - 发信人
amerce - 罚款
agonise - 烦恼
agonising - 烦恼的
adversative - 反意的
albedo - 反照率
alibi - 犯罪现场
affine - 仿射
accessing - 访问
amplify - 放大
actinomycosis - 放射菌病
aeroplane - 飞机
airplane - 飞机
airstrip - 飞机跑道
airship - 飞艇
airmanship - 飞行术
all-important - 非常重要的
alogical - 非逻辑的
accusatory - 非难的
amuck - 疯狂地
alveolate - 蜂窝状的
adulate - 奉承
aerosol - 浮质
addled - 腐坏的
agnate - 父系
affixation - 附加
additive - 附加的
adrate - 附加税
affix - 附加物
add-in - 附加项
accessories - 附件
accessory - 附件
Add-ons - 附件
addenda - 附录
accessary - 附属的
accessorial - 附属的
adjunct - 附属的
adjunctive - 附属的
affiliated - 附属的
anabiosis - 复苏
ad. - 副词
adverb - 副词
activator - 催化剂
acne - 痤疮
aloud - 大声地
ambassador - 大使
agglomerate - 大团
agency fee - 中介费
pail - 洗衣桶
The Himalayas - 喜马拉雅山
prawn - 虾
show - 显示,表明
county - 县
rattlesnake - 响尾蛇
gazelle - 小羚羊
heifer - 小母牛
gilt - 小母猪
billy - 雄山羊
cob - 雄天鹅
repair - 修复，修补
open-minded - 虚心的
credit system - 学分制
society - 学会
education - 学历
school year - 学年
semester - 学期
student body - 学生(总称)
bachelor - 学士
degree - 学位
cod - 鳕鱼
sturgeon - 鲟鱼
well-trained - 训练有素的
toothbrush - 牙刷
ashtray - 烟灰缸
smoking set - 烟具
hog - 阉猪,肥猪
punctual - 严守时刻的
graduate school - 研究生院
seminar - 研讨班
mole - 鼹鼠
mutton - 羊肉
alpaca - 羊驼
balcony - 阳台
rocking chair - 摇椅
remote control - 遥控器
ray - 鳐鱼
open university - 夜大、函大
amicable - 友好的
friendly - 友好的
able - 有才干的，能干的
original - 有独创性的
inventive - 有发明才能的，有创造力的
methodical - 有方法的
dedicated - 有奉献精神的
aggressive - 有进取心的
capable - 有能力的，有才能的
systematic - 有系统的
pied-a-terre - 临时住宿处
comer - 来者
erratic - 不稳定的
acquit - 宣告无罪
a bull in a china shop - 莽撞闯祸的人
all wool and a yard wide - 优质的
a castle in the air - 空中楼阁
a bolt from the blue - 意外事件
an eye for an eye - 以眼还眼
a slap in the face - 耳光
a point of no return - 航线临界点
a place in the sun - 显要的地位
a storm in a teacup - 小题大作
a frog in the throat - 轻度喉咙沙哑
translation - 转译
Trypanosoma - 锥虫属
allowance - 准许
trophoblast - 滋养层
uterus - 子宫
endometrium - 子宫内膜
adenomyosis - 子宫内膜异位症
hysterectomy - 子宫切除术
ascospore - 子囊孢子（在囊菌纲之子囊里所产生之孢子）
Astragalus - 紫云英属；黄蓍属
idiopathic - 自发性的
autolysis - 自溶
autogenous - 自生的
autogeneic - 自体的
autologous - 自体的；自家的
autopolyploid - 自体多套染色体
autograft - 自体移植物（取自自身之组织移植片）
ordinate - 纵线
pedal - 足的
colony - 族群
population - 族群
repression - 阻遏；压抑
histidine - 组胺酸
tissue - 组织
histamine - 组织胺
histopathology - 组织病理学
histone - 组织蛋白
Histoplasma - 组织浆菌属
langur - Presbytis属之长尾猿
serotonin - 5－羟色胺
X-irradiation - X照射光
a land flowing with milk and honey - 鱼米之乡
a matter of life and death - 生死攸关的事
American standard code for information interchange - 美国标准信息交组
diagnosis - 诊断
exanthema - 疹；红斑
airy  - 空气的,耸立空中的,通风的,幻想的,轻浮的,轻快的,优美的,装腔作势的,通风,
alarm  - 惊慌,挂念,警报,紧急召集,警报器,唤醒装置,使警戒,惊动,惊,
album  - 像片簿,邮票黏贴簿,来宾签名簿,乐谱帖,唱片套册,簿册,
alley  - 背街,小路,小巷,小径,保龄球馆,巷道,巷,胡同,弄,
alleyway  - 小巷,背街,窄街,
alliance  - 同盟,盟约,联姻,同盟国,同盟者,关连性,类似,联盟,联合,
allied  - 同盟的,联合的,联合国的,姻亲的,有关连的,同类的,
allocate  - 分配,调配,支配,
allusion  - 暗示,暗指,暗讽,言及,引喻,引述,
almost  - 几乎,有时用作形容词,垂,殆,几,将近,
along  - 沿著,循著,一同,顺,沿,缘,
also  - 又,也,同样,加之,同时也,还,并,亦,载,
alt  - 切换,中高音,中高音的,
ALU  - 算术逻辑部件
AM  - 是,在,午前
amaranth  - 不凋花,苋属植物,紫红色,
amber  - 琥珀,琥珀色,琥珀制的,琥珀色的,珀,琥,
ambition  - 雄心,野心,热望,所热望的事物,野心的目标,抱负,
amendment  - 修正,修正案,订正,改正,改过,美国宪法的修正案,
amiss  - 错,不适当,不顺利,差错,不方便,变坏,错误的,不对,不是味儿,
amongst  - 在...当中,在...之间,在...之中,
anatomy  - 解剖,解剖学,构造,组织,骸骨,瘦巴巴的人,
ancestor  - 祖先,先祖,先驱者,被继承人,宗,祖,
ancestral  - 祖先的,祖先传下的,祖祖宗宗的,
anger  - 怒,生气,愤怒,气,忾,怫,
anglo-american  - 祖籍英国的美国人,英美的,祖籍英国的美国人的,
ANN  - 安
annex  - 附加,追加,并吞,侵吞,加添物,附件,加建建筑,别馆,合并,
annihilate  - 绝灭,消灭,废止,抹杀,灭绝,歼,
announce  - 通知,发表,大声传达,显示,作为预告,当广播员,声名参加竞选,宣布,敷,
ano -  ,作者不详的,佚名的,无名的
anodyne  - 止痛药,镇痛剂,止痛的,
another  - 另外的,别的,另外一个,别人,别的东西,另一,别,另,再,
antagonist  - 忠顺,忠诚,忠贞,忠实,对手,敌手,
anticipation  - 预期,期待,预支,占先,预防,事前行为,前发,先行音,期望,
anti-Comintern  - **产党的,
antipodal  - 对跖地的,对跖的,正相反的,
anvil  - 铁砧,砧骨,砧,
AP  - 美联社
APC  - 异步过程调用
API  - 应用程式介面
apostate  - 背教者,变节者,脱党者,背教的,变节的,脱党的,
apparent  - 显而易见的,明白,外观上的,外表上的,表面的,与,字源相同,明显的,表观,
appear  - 出现,显现,显得...被认为...出场,报到,被发表,被登载,变明白,变清楚,现,
appetite  - 食欲,欲望,欲求,嗜好,爱好,欲,
babble  - 牙牙学语,唠叨,潺潺作声,说露了嘴,含糊之辞,潺潺声,
abrasive  - 研磨的,磨擦的,研磨剂,金刚砂,粗厉的,粗厉,
abridge  - 缩短,省略,摘要,撮要,抄录,缩小,缩减,剥夺,减少,
absorption  - 吸收,专心,专心一意,凝神,合并,吸收营养,
abundance  - 丰富,富足,多,充裕,富裕,充足,
governess - 女家庭教师
schoolgirl - 女生
drainage - 排水道
auditor - 旁听生
auditor - 旁听生（美）
penguin - 企鹅
modest - 谦虚的
squid - 枪乌贼,鱿鱼
bracket - 墙上突出之托架
herring - 青鱼,鲱
district - 区
heating - 取暖费
cancellation - 取消预定
anthropology - 人类学
recognize - 认清（职责等）
earnest - 认真的
conscientious - 认真的，自觉的
fluorescent lamp - 日光灯
tick - 褥子
intern - 实习生
realize - 实现（目标等）；获得（利润）
larder - 食品柜
room and board - 食宿
anteater - 食蚁兽
unify - 使成一体,统一
localize - 使地方化
enrich - 使丰富
perfect - 使完善；改善
regularize - 使系统化
modernize - 使现代化
adaptable - 适应性强的
trolley - 手推车
disciplined - 守纪律的
orderly - 守纪律的
faithful - 守信的，忠诚的
initiative - 首创精神
curriculum - 课程
timetable - 课程表
after-school activities - 课外活动
peacock - 孔雀
control - 控制
control tower - 控制台
oral test - 口试
generous - 宽宏大量的
Garbage - 垃圾费
old boy - 老生
straightforward - 老实的
divorced - 离异
auditorium - 礼堂
polytechnic institute - 理工学院/科技大学
pied-a-terre - 临时住宿处
comer - 来者
erratic - 不稳定的
acquit - 宣告无罪
rice noodles - 米粉
retail - 散户
restructuring of enterprise - 企业改制
responsibility system - 责任制
respiratory failure - 呼吸衰竭
residence booklet - 户口簿
reserve funds - 储备基金
reserve fund - 备用资金
research results - 研究成果
Research Associate - 助理研究员
Research Assistant - 研究实习员
rescue workers - 救援人员
Registrar - 注册主管
registered permanent residence - 户籍所在地
registered capital - 注册资本
safe driving - 安全行车
sado - 茶道
rural credit cooperatives - 农村信用社
royalty rate - 版税率
round-trip ticket - 往返票
rollercoaster - 过山车
roller coaster - 过山车
rob Peter to pay Paul - 拆东墙补西墙
returned students - 归国留学生
returned overseas Chinese - 归侨
literature - 文学
international -  国际的
invoice -  发票
medium -  中等，中级的
maximum - 　 最大的、最大限度的
metric ton -  公吨
net weight -  净重
packing list -  装箱单、明细表
percent -  百分比
price -  价格
purchase -  购买、购货
reference -  参考、查价
sales contract -  销售确认书
telex -  电传
Annals - 纪事
 - 禁用词
Volume - 卷
Annual - 年鉴，年度
Abstracts - 文摘
Institute - 学会、研究所
Dissertations - 学位论文
tableware - 餐具
dining table - 餐桌
heron - 苍鹰
plug - 插头
coffee table - 茶几
tea table - 茶几
cicada - 蝉
toad - 蟾蜍
generate - 产生
gibbon - 长臂猿
bolster - 长枕
garage - 车库
succeed - 成功
report card - 成绩单
adult education - 成人教育
honest - 诚实的
export - 出口
Cashier - 出纳员
Physical Education - 体育
Chief Engineer - 总工程师
Sales Engineer - 销售工程师
software engineering - 软件工程
College English - 大学英语
business experience - 工作经历
research fellow - 研究员
International Finance - 国际金融
Computer Graphics - 图形学原理
professional history - 职业经历
participate in - 参加
second job - 第二职业
Contract Law - 合同法
job objective - 工作目标
sort out - 清理
business phone - 办公电话
home phone - 住宅电话
office phone - 办公电话
College Physics - 大学物理
native place - 籍贯
social practice - 社会实践
Word Processing - 数据处理
associate professor - 副教授
guest professor - 客座教授
autonomous region - 自治区
Public Relation - 公共关系学
Operational Research - 运筹学
research society - 研究会
family status - 家庭状况
marital status - 婚姻状况
foreign student - 外国学生
graduate student - 研究生
phyto- - 与「植物」有关之字首
ad- - 与「至」、「向」、「近」有关之字首
peri- - 与「周围」有关之字首
levo- - 与「左旋的」有关之字首
breeding - 育种；繁殖
preconditioning - 预处理
prevention - 预防
prophylaxis - 预防
caveat - 预告
prognosis - 预後
verruca - 疣
wart - 疣
organophosphate - 有机磷
appetitive - 有食慾的
mitosis - 有丝分裂
conditioned - 有条件的；条件的
gametogenesis - 有性生殖
syngenesis - 有性生殖
nymph - 幼虫
neoteny - 幼龄延长；稚龄延长
fawn - 幼鹿；小动物；小山羊
inducer - 诱导体；诱发体
spinner - 诱饵
protamine - 鱼精蛋白
schizo- - 与「分裂」有关之字首
photo- - 与「光」有关之字首
translocation - 移位
transplantation - 移植
transplant - 移植；移植物
hereditary - 遗传性的
ethyl - 乙基
acetaminophen - 乙醯胺苯酚
paracetamol - 乙醯胺苯酚
acetylcholine - 乙醯胆硷
acetylation - 乙醯化
calcitonin - 抑钙素；降钙素
suppression - 抑制
inhibition - 抑制作用
heteroecious - 易主的（表示一寄生虫须有两个或更多的寄主在其生活史中）
vaccination - 疫苗接种
alar - 翼的
vulva - 阴唇
vagina - 阴道
vaginitis - 阴道炎
clitoris - 阴蒂；阴核
phallus - 阴茎；阴蒂；阴茎原素；交接器原基；胚胎外阴结节
hematocele - 阴囊积水
silver - 银
citation - 引证
cryptosporidiosis - 隐胞子虫病
ascendancy  - 优越,优势,支配权,
ascendent  - 运星,运道,支配力,优势,上升的,占优势的,
assembling  - 汇编,组合,装配,
assent  - 同意,赞同,赞成,
assert  - 主张,硬说,断言,声明,声称,宣称,
assignor  - 分配者,委派者,转让者,
assuage  - 缓和,减轻,镇定,
assumption  - 采取,承担,臆测,傲慢,僭越,假装,圣母升天,圣母升天节,假定,
assure  - 保证,担保,说得确实是...,叫放心,使安心,使确定,弄确定,保险,包管,
assuredness  - 确实,确信,自信,
asterisk  - 星标 ,*
at  - 在...,做,正在,中,向,以,用,在,于,
attachment  - 附著,固著,附著物,附属品,依恋,执著,逮捕,拘留,附件,
attack  - 攻击,侵害,著手,突然的发病,动手,捣,攻打,抨,征,
attain  - 达,获得,逐,达到目的,达到,高达,
attaint  - 宣告剥夺财产权,损坏,玷污,私权丧失,污点,耻辱,
attentive  - 注意周到的,倾听的,恳切的,殷勤的,周,仔细,
attestation  - 证明,证据,证言,
attraction  - 吸引,牵引,引力,引人之力,魅力,惹眼之物,有趣之物,叫座之物,吸引力,
attractive  - 引人注意的,有魅力的,媚人的,有引力的,吸引人的,引人注意,
audacity  - 大胆,厚脸,**,厚脸皮,旁若无人,无礼,
automatically  - 自动地,机械地,自然而然,
automation  - 自动化,自动控制,自动操作,
automatism  - 自动,自动作用,自动力,
avalanche  - 雪崩,山崩,涌到之物,崩落,涌至,大量投入,
average  - 平均,一般,海损,平均的,非常的,通常的,均分,平均是,普通,
avow  - 声明,承认,招认,
aware  - 知道,晓得,注意到,觉察到,察觉,觉,
Axes  - 轴,轴线,轴心,
axial  - 轴的,成轴的,轴周围的,
axis  - 轴,轴线,茎轴,第二颈椎,第二脊椎骨,轴心,
beneficial  - 有益的,有利的,慈善的,享受利益的,获得利益的,受益的,
beside  - 在旁,在...身边,与...比较,隔著...,离开...,在旁边,在...之旁,旁,在┅之旁,
betray  - 背叛,出卖,背,骗,泄露,表示,
bias  - 斜线,成见,球的歪斜,偏倚,斜的,交叉,使存偏见,偏斜,偏差,
bicker  - 拌嘴,斗嘴,潺潺而流,闪动,口角,流水声,
biggest  - 大的,长大的,最大,
bigness  - 大,伟大,重大,
billion  - 十亿,兆,秭,
bin  - 储藏箱,柜,收藏室,采蛇麻草的帆布袋,收入于箱,箱子,
birthmark  - 胎记,胎痣,痣,
bitter  - 苦的,难堪的,剧痛的,悲痛的,刺寒,激烈,苦的东西,苦酒,苦,
blackguard  - 无赖,流氓,辱骂,行为如流氓,庸俗的,滥骂的,
blackness  - 黑暗,黑,黑色,阴郁,阴险,凶恶,
blare  - 巨响,吼叫声,光泽,高声鸣叫,大叫,大声喊出,
blight  - 枯萎病,害虫,浓雾,障害,阴影,使枯萎,妨碍,枯萎,挫折,
blocking  - 闭塞,合块,阻塞,
blood  - 血,红色液,生命,牺牲,名门,气质,血气方刚的男人,抽血,血液,
blossom  - 花,群花,开花期,花季,初期,开花,繁荣,繁盛,变成,
AAAS  - 美国科学发展协会，美国科学艺术研究院
alarm  - 惊慌,挂念,警报,紧急召集,警报器,唤醒装置,使警戒,惊动,惊,
album  - 像片簿,邮票黏贴簿,来宾签名簿,乐谱帖,唱片套册,簿册,
alley  - 背街,小路,小巷,小径,保龄球馆,巷道,巷,胡同,弄,
alleyway  - 小巷,背街,窄街,
alliance  - 同盟,盟约,联姻,同盟国,同盟者,关连性,类似,联盟,联合,
allied  - 同盟的,联合的,联合国的,姻亲的,有关连的,同类的,
allocate  - 分配,调配,支配,
allusion  - 暗示,暗指,暗讽,言及,引喻,引述,
almost  - 几乎,有时用作形容词,垂,殆,几,将近,
along  - 沿著,循著,一同,顺,沿,缘,
also  - 又,也,同样,加之,同时也,还,并,亦,载,
alt  - 切换,中高音,中高音的,
ALU  - 算术逻辑部件
AM  - 是,在,午前
amaranth  - 不凋花,苋属植物,紫红色,
amber  - 琥珀,琥珀色,琥珀制的,琥珀色的,珀,琥,
ambition  - 雄心,野心,热望,所热望的事物,野心的目标,抱负,
amendment  - 修正,修正案,订正,改正,改过,美国宪法的修正案,
amiss  - 错,不适当,不顺利,差错,不方便,变坏,错误的,不对,不是味儿,
amongst  - 在...当中,在...之间,在...之中,
anatomy  - 解剖,解剖学,构造,组织,骸骨,瘦巴巴的人,
ancestor  - 祖先,先祖,先驱者,被继承人,宗,祖,
ancestral  - 祖先的,祖先传下的,祖祖宗宗的,
anger  - 怒,生气,愤怒,气,忾,怫,
anglo-american  - 祖籍英国的美国人,英美的,祖籍英国的美国人的,
ANN  - 安
annex  - 附加,追加,并吞,侵吞,加添物,附件,加建建筑,别馆,合并,
annihilate  - 绝灭,消灭,废止,抹杀,灭绝,歼,
announce  - 通知,发表,大声传达,显示,作为预告,当广播员,声名参加竞选,宣布,敷,
ano -  ,作者不详的,佚名的,无名的
anodyne  - 止痛药,镇痛剂,止痛的,
another  - 另外的,别的,另外一个,别人,别的东西,另一,别,另,再,
antagonist  - 忠顺,忠诚,忠贞,忠实,对手,敌手,
anticipation  - 预期,期待,预支,占先,预防,事前行为,前发,先行音,期望,
anti-Comintern  - **产党的,
antipodal  - 对跖地的,对跖的,正相反的,
anvil  - 铁砧,砧骨,砧,
AP  - 美联社
APC  - 异步过程调用
API  - 应用程式介面
apostate  - 背教者,变节者,脱党者,背教的,变节的,脱党的,
apparent  - 显而易见的,明白,外观上的,外表上的,表面的,与,字源相同,明显的,表观,
appear  - 出现,显现,显得...被认为...出场,报到,被发表,被登载,变明白,变清楚,现,
appetite  - 食欲,欲望,欲求,嗜好,爱好,欲,
babble  - 牙牙学语,唠叨,潺潺作声,说露了嘴,含糊之辞,潺潺声,
abrasive  - 研磨的,磨擦的,研磨剂,金刚砂,粗厉的,粗厉,
abridge  - 缩短,省略,摘要,撮要,抄录,缩小,缩减,剥夺,减少,
absorption  - 吸收,专心,专心一意,凝神,合并,吸收营养,
abundance  - 丰富,富足,多,充裕,富裕,充足,
AC  - 鉴别码
democratic supervision - 民主监督
democracy at the grassroots level - 基层民主
demo - 演绎版
delivery - 交割
credentialism - 文凭主义
coverage rate - 覆盖率
be promoted to - 被提升为
date of birth - 出生日期
ID card No. - 身份证号码
Digital Image Processing - 数字图像处理
Microeconomics & Macroeconomics - 西方经济学
Automatic Control System - 自动控制系统
forceful - （性格）坚强的
apartment - （一户）公寓房间
discreet - （在行动，说话等方面）谨慎的
Chief Accountant - 总会计主任
Cost Accounting - 成本会计
disarmament - 裁军
die-hard - 顽固分子
Diaoyu Islands - 钓鱼岛
dialogue and co-operation - 对话和合作
development contract - 开发性承包
development company - 开发公司
all-year - 全年度的
across-the-board - 全盘的
absorbed - 全神贯注的
aircrew - 全体机组人员
all-weather - 全天候的
all-knowing - 全知的
aldehyde - 醛
aldose - 醛醣
admonish - 劝告
advise - 劝告
advisement - 劝告
alkine - 炔属
Americana - 美国文物
Amerindian - 美国印地安人
Amtrak - 美铁
ambrosia - 美味食物
aesthetics - 美学
Amex - 美证券交易所
alligator - 美洲鳄鱼
adream - 梦想的
alluring - 迷人的
airtight - 密封的
affinity - 密切关系
absolution - 免罪
acreage - 面积
aimer - 瞄准手
allergy - 敏感症
amido - 氨基
amino - 氨基的
ammonolysis - 氨解作用
ammonium - 铵
alphabetically - 按字母顺序地
agenda - 备忘录
air-conditioned - 备有空调装置的
adopted - 被采用的
adoptee - 被收养者
aloof - 避开
acock - 边翻卷地
amygdalae - 扁桃腺
allergen - 变态反应原
amoebae - 变形虫
aeroelastic - 变形的
all-pervasive - 遍及各方面的
allegation - 辩解
accusative - 宾格
acetone - 丙酮
acrylate - 丙烯酸盐
aetiological - 病因论的
all around - 周围
according as - 依据
act as - 担当
aim at - 瞄准
Academy Award - 奥斯卡奖
a certain - 某一
Alsace - 阿尔萨斯
Altaic - 阿尔泰山的
Altai - 阿尔泰语
Afghanistan - 阿富汗
Afghan - 阿富汗的
Agamemnon - 阿伽门农
Achilles - 阿基里斯
Akkadian - 阿卡得人
Acadian - 阿卡迪亚的
Accra - 阿克拉
Allah - 阿拉
Alabama - 阿拉巴马州
acacia - 阿拉伯树胶
algorism - 阿拉伯数字系统
Alaskan - 阿拉斯加人
Alaska - 阿拉斯加州
Aladdin - 阿拉延
Ammon - 阿蒙神
Amitabha - 阿弥陀佛
ameba - 阿米巴
amebic - 阿米巴的
Amos - 阿摩司
Acheulean - 阿舍利时期的
approve  - 核准,赞成,承认,批可,显示,证实,批准,认证,赞同,
apt  - 有...倾向的,...似的,适当的,巧的,头脑好的,易于,
APT  - 倾向于的,易于的,恰当的,聪明的
arachnoid  - 蛛网状的,蛛网膜的,蛛网膜,
arduous  - 费力的,艰辛的,奋斗的,刻苦的,难登的,险峻的,险峻,困难,艰苦,
argumentative  - 好辩的,爱穷根究理的,争论的,
arises  - 发生,出现,站立,
aristocratic  - 贵族政治的,贵族的,贵族似的,相貌堂堂的,气派高雅的,贵族化,
army  - 军队,陆军,大群,团体,兵团,部队,军,陆海空三军,营,
Around  - 在...周围,在...各处,大约,在周围,在附近,各处,
arraign  - 提讯,传问,责难,
arraignment  - 提讯,传问,责难,
arrival  - 抵达,出现,登场,到达者,抵达物,新生儿,出生,到达,到来,
artistic  - 技术的,艺术的,美术的,美术家的,艺术家的,风雅的,
ascendance  - 优越,权势,主权,
ascendancy  - 优越,优势,支配权,
ascendent  - 运星,运道,支配力,优势,上升的,占优势的,
assembling  - 汇编,组合,装配,
assent  - 同意,赞同,赞成,
assert  - 主张,硬说,断言,声明,声称,宣称,
assignor  - 分配者,委派者,转让者,
assuage  - 缓和,减轻,镇定,
assumption  - 采取,承担,臆测,傲慢,僭越,假装,圣母升天,圣母升天节,假定,
assure  - 保证,担保,说得确实是...,叫放心,使安心,使确定,弄确定,保险,包管,
assuredness  - 确实,确信,自信,
asterisk  - 星标 ,*
at  - 在...,做,正在,中,向,以,用,在,于,
attachment  - 附著,固著,附著物,附属品,依恋,执著,逮捕,拘留,附件,
attack  - 攻击,侵害,著手,突然的发病,动手,捣,攻打,抨,征,
attain  - 达,获得,逐,达到目的,达到,高达,
attaint  - 宣告剥夺财产权,损坏,玷污,私权丧失,污点,耻辱,
attentive  - 注意周到的,倾听的,恳切的,殷勤的,周,仔细,
attestation  - 证明,证据,证言,
attraction  - 吸引,牵引,引力,引人之力,魅力,惹眼之物,有趣之物,叫座之物,吸引力,
attractive  - 引人注意的,有魅力的,媚人的,有引力的,吸引人的,引人注意,
audacity  - 大胆,厚脸,**,厚脸皮,旁若无人,无礼,
automatically  - 自动地,机械地,自然而然,
automation  - 自动化,自动控制,自动操作,
automatism  - 自动,自动作用,自动力,
avalanche  - 雪崩,山崩,涌到之物,崩落,涌至,大量投入,
average  - 平均,一般,海损,平均的,非常的,通常的,均分,平均是,普通,
avow  - 声明,承认,招认,
aware  - 知道,晓得,注意到,觉察到,察觉,觉,
Axes  - 轴,轴线,轴心,
axial  - 轴的,成轴的,轴周围的,
axis  - 轴,轴线,茎轴,第二颈椎,第二脊椎骨,轴心,
beneficial  - 有益的,有利的,慈善的,享受利益的,获得利益的,受益的,
beside  - 在旁,在...身边,与...比较,隔著...,离开...,在旁边,在...之旁,旁,在┅之旁,
betray  - 背叛,出卖,背,骗,泄露,表示,
bias  - 斜线,成见,球的歪斜,偏倚,斜的,交叉,使存偏见,偏斜,偏差,
according to - 依照
agree upon - 意见一致
amplify on - 引伸
account receivable - 应收款
administer to - 有助于
after all - 毕竟
all alone - 独立地
all along - 自始自终
acute angle - 锐角
acetic anhydride - 乙酸酐
all appearance - 显然
air travel - 空中旅行
aerial photography - 空中摄影
aerial railway - 空中索道
air hostess - 空中小姐
accuse of - 控告
absent from - 离开
affiliated company - 联营公司
aluminum foil - 铝箔
ammonium chloride - 氯化铵
american revolution - 美国独立战争
American Indian - 美国印地安人
America online - 美国在线服务公司
allied forces - 盟军
agent provocateur - 密探
alarm clock - 闹钟
act on - 起作用
air hole - 气孔
all of - 实足
accident insurance - 事故保险
all square - 势均力敌
adapt to - 适合
adjust to - 适应
after service - 售后服务
account for - 说明
agony column - 私事广告栏
acid radical - 酸根
acid reaction - 酸性反应
acid soil - 酸性土壤
admitting that - 虽然说
all references - 所有引用
aerated water - 碳酸水
ad hoc - 特别
add in - 添加
add color - 添加颜色
accede to - 同意
agree to - 同意
accord with - 符合
additional tax - 附加税
adjunct professor - 副教授
cashing - 兑现
oem - 定牌生产
aeolus - 风神
sba - 小企业管理局
prescience - 先见
cashes - 现金
commensurability - 可通约性
approximate - 大概的
suppler - 供应商
pertain - 属于
deferral - 递延
managerial - 经理的
pharmacon - 药品
evasion - 偷漏税
secede - 退出
computerize - 电脑化
compaq - 康柏
acquit - 表现
proximity - 接近性
armament - 兵器
penrose - 彭罗斯
prospectus - 计划书
ledger - 总账
ennui - 倦怠
vested - 既定的
catholicon - 灵丹妙药
bass - 巴斯
expire - 期满
federacy - 联盟
 - 
convened - 转换
entry - 加入
liberalization - 自由化
renewable - 可再生的
foreign - 对外
asean - 东盟
claim - 索赔
eu - 欧盟
bilateral - 双边
online - 网上
hotels - 酒店
division - 分工
agreement - 协定
opening - 对外开放
disputes - 争端
preferring - 偏好
unveiling - 披露
asserts - 资产
equities - 权益
loyally - 忠诚
Institute - 学会、研究所
Dissertations - 学位论文
Journal - 杂志、刊
Symposium - 专题学术讨论会
Encyclopedia - 百科全书
Semi-Annual - 半年度
Gazette - 报，公报
Heading - 标题词
Press - 出版社
Classification - 分类，分类表
Keyword - 关键词
Transactions - 汇报、汇刊
Record - 记录、记事
Advances - 进展
Progress - 进展
Topics - 论题、主题
Papers - 论文
Directory - 名录，指南
Content - 目次
List - 目录、一览表
Yearbook - 年鉴
Title - 篇名、刊名、题目
Review - 评论、综述
Issue - 期（次）
Handbook - 手册
Manual - 手册
Bibliography - 书目，题录
Abbreviation - 缩语和略语
Index - 索引
Summary - 提要
Bulletin - 通报，公告
Archives - 文献集
Thesaurus - 叙词表、词库
Acta - 学报
Guide - 指南
Subject - 主题
Author - 作者
Electronic Data Interchange   - 电子数据交换
For your information   - 供参考
With respect to   - 关于
Be right back   - 很快回来
By the way   - 随便说一下
I love you   - 我爱你
See you later   - 下次再会
Domain Name System   - 域名系统
Free on Board   - 装运港船上交货价
For example    - 举例
girlfriend     - 女朋友
In any event   - 无论如何
Thank you    - 谢谢
air tank - 氧气筒
all together - 一起
all through - 一直
according to - 依照
agree upon - 意见一致
amplify on - 引伸
account receivable - 应收款
administer to - 有助于
after all - 毕竟
all alone - 独立地
all along - 自始自终
acute angle - 锐角
acetic anhydride - 乙酸酐
all appearance - 显然
air travel - 空中旅行
aerial photography - 空中摄影
aerial railway - 空中索道
air hostess - 空中小姐
accuse of - 控告
absent from - 离开
affiliated company - 联营公司
aluminum foil - 铝箔
ammonium chloride - 氯化铵
american revolution - 美国独立战争
American Indian - 美国印地安人
America online - 美国在线服务公司
allied forces - 盟军
agent provocateur - 密探
alarm clock - 闹钟
act on - 起作用
air hole - 气孔
all of - 实足
accident insurance - 事故保险
all square - 势均力敌
adapt to - 适合
adjust to - 适应
after service - 售后服务
account for - 说明
agony column - 私事广告栏
acid radical - 酸根
acid reaction - 酸性反应
acid soil - 酸性土壤
admitting that - 虽然说
all references - 所有引用
aerated water - 碳酸水
ad hoc - 特别
add in - 添加
add color - 添加颜色
accede to - 同意
agree to - 同意
Aldine - 豪华版的
alright - 好吧
acclaim - 喝彩
amalgamate - 合并
aggregate - 合计
aikido - 合气道
amaurosis - 黑内障
Africanization - 非洲化
adiposity - 肥胖
adiposis - 肥胖病
allocate - 分派
allocation - 分配
allot - 分配
allotment - 分配
amortisation - 分期偿还
ado - 纷扰
ambrosial - 芬香的
amidin - 粉溶素
abundant - 丰富
air-dry - 风干的
affluently - 富裕地
alvine - 腹的
alterative - 改变的
ameliorant - 改良物
ameliorate - 改善
amelioration - 改善
ameliorative - 改善的
amendatory - 改善的
airer - 干燥器
algesia - 感觉过敏
aery - 高处的巢
ALT. - 高度
altitude - 高度
altitudinal - 高度的
altimeter - 高度计
advanced - 高级的
aerialist - 高空杂技师
alp - 高山
alt - 高音
alme - 歌女
all-party - 各党派的
affiche - 公告
affront - 公开侮辱
acknowledged - 公认的
admitted - 公认的
Afrikaans - 公用荷兰语
aggress - 攻击
admiral - 海军上将
allopatric - 发生的
addresser - 发信人
amerce - 罚款
agonise - 烦恼
agonising - 烦恼的
adversative - 反意的
albedo - 反照率
alibi - 犯罪现场
affine - 仿射
accessing - 访问
amplify - 放大
actinomycosis - 放射菌病
aeroplane - 飞机
airplane - 飞机
airstrip - 飞机跑道
airship - 飞艇
airmanship - 飞行术
all-important - 非常重要的
alogical - 非逻辑的
accusatory - 非难的
amuck - 疯狂地
alveolate - 蜂窝状的
adulate - 奉承
aerosol - 浮质
addled - 腐坏的
agnate - 父系
affixation - 附加
additive - 附加的
adrate - 附加税
affix - 附加物
add-in - 附加项
accessories - 附件
accessory - 附件
Add-ons - 附件
addenda - 附录
accessary - 附属的
accessorial - 附属的
adjunct - 附属的
adjunctive - 附属的
affiliated - 附属的
anabiosis - 复苏
ad. - 副词
adverb - 副词
activator - 催化剂
acne - 痤疮
aloud - 大声地
ambassador - 大使
agglomerate - 大团
Alcor - 第五星
ammeter - 电表
airwave - 电视
airwaves - 电视广播
maid  - 处女,未婚女子,少女,闺女,女仆,侍女,
maiden  - 处女,少女,闺女,一种断头台,未婚的,纯洁的,初次的,未赢过的,处女的,
mercury  - 水银,水银柱,温度计,晴雨计,活力,精力,山木蓝类,水星,汞,
mere  - 仅是,单单,丝毫没有别的,全然的,只是,仅仅的,
messenger  - 使者,信差,送电报的人,送公文的信差,报信者,前驱,前兆,补助索,使,
metalloid  - 象金属的,非金属的,类似金属性的,非金属,类似金属,两性金属,
metre  - 公尺,格,韵律,
mew  - 海鸥,咪咪叫,鹰笼,巢,隐匿处,放进笼里,关起来,偷换,猫叫声,
miasma  - 瘴气,氛,瘴,
midday  - 正午,白昼,中午,
midst  - 中央,正中,当中,中间,在中央,在正中,
migrate  - 迁居,迁移,转移,
military  - 或许,大概,军事,军事的,兵,军,军方,武,武装,
million  - 百万,无数,多数,百万元,百万磅,民众,大众,百万的,多数的,
millstone  - 磨石,碎器,重担,
mine  - 我的东西,我的家人,我的,矿山,坑道,秘密策略,采矿,破坏,矿,
miniature  - 缩小画,纤细画法,缩图,小型,小型的,缩图的,绘成纤细画,缩印,缩小模型,
minimal  - 最小的,极微的,最小限度的,
ministry  - 牧师之职,部长之职,圣职者们,内阁,诸部长,公使团,服侍,部门,部,
minium  - 铅丹,铅丹色,朱砂色,
Minor  - 未成年人,副修科目,较小的,二流的,未成年的,辅修,
keel  - 龙骨,船,龙骨瓣,龙骨突起,平底船,使倾覆,
keeper  - 守卫,监护人,服侍者,管理者,所有人,守门员,记录员,耐储藏的水果,管理人,
keeping  - 保持,保管,管理,看守,监护,扶养,粮食,调和,呼应,
ken  - 视界,眼界,知识范围,
keystone  - 拱心石,楔石,重点,
kickoff  - 开球,开始,肇始,
kidnap  - 绑架,拐骗,诱拐,拐走,绑票,拐,
kidney  - 肾脏,羊,牛的腰子,性质,气质,肾,
Kind  - 种类,性质,方式,亲切的,仁慈的,和蔼的,
kinsman  - 有做...的倾向,易...的,负有责任的,有做...责任的,男性亲戚,男性亲属,
knap  - 打碎,拗断,打,山顶,小山,丘陵,
knee  - 膝关节,衣服的膝部,托架,隅材,用膝盖碰,以合角铁接合,加以合角铁,膝盖,膝,
knell  - 钟声,吊丧的钟声,不吉利的预兆,报知噩耗,传出不吉声响,丧钟,
knockdown  - 击倒的,组合式的,预铸组合式,压倒者,烈酒,组合式物,
knuckle  - 手指关节,膝关节,钩爪,用指关节打,将指关节触地,指关节,
lacca  - 虫胶,虫漆,紫草茸,
ladder  - 梯子,梯状物,救生梯班,梯形裂缝,进身的阶梯,立身成名的手段,架梯,阶梯,梯,
laic  - 凡人,俗人,外行,凡人的,俗人的,外行的,
lamentable  - 可悲的,可叹的,可怜的,低劣的,贫乏的,可悲,
landmark  - 快乐的,快活的,高兴的,使欢喜的,陆标,界标,
LAP  - 腰以下及大腿的前面部分,山坳,一圈,一段行程,掌管、掌握,被包住,
largely  - 心胸宽宏地,大部份,主要地,甚多,丰富,大规模,
laten  - (使)变迟,
lathe  - 车床,陶器,镟床,用车床加工,旋,镟,
latter  - 后面的,后方的,后期的,末尾的,后者的,挽近的,近来的,后者,下,
latterly  - 近来,在晚年,在后期,
laurel  - 月桂树,美国石南花,月桂冠,名誉,荣冠,胜利,授予桂冠,授予荣誉,月桂,
lawfully  - 适法地,合法地,正当地,
lawless  - 无法律的,不遵守法律的,无法的,非法的,不照顺序的,不法,
financial - 融资
multinational - 跨国公司
merger - 并购
advantage - 优势的
enterprise - 为企业
clusters - 集群
supplier - 供应商
acquisition - 购
stock - 股权
transnational - 跨国
control - 控制权
salary - 薪酬
team - 团队
earnings - 盈余
managers - 经营者
outsourcing - 外包
owner - 所有者
acquisitions - 购
merger - 兼并
manager - 经理人
operator - 经营者
haier - 海尔
appraisal - 考核
personnel - 员工
lean - 精益
goodwill - 商誉
financial - 理财
achievement - 绩效
erp - 企业资源计划
partnership - 伙伴关系
tax - 纳税
equity - 权益
managerial - 经营
owners - 所有者
enterpriser - 企业家
stakeholders - 利益相关者
reengineering - 重组
enterprise - 企业
